,Abs_Total,Occupied,Vacant,Geography,NAME,state,county,tract,State
1,2414,2326,88,1400000US17001000100,"Census Tract 1,Adams County",17,001,000100,Illinois
2,902,845,57,1400000US17001000201,"Census Tract 2,01,Adams County",17,001,000201,Illinois
3,1110,952,158,1400000US17001000202,"Census Tract 2,02,Adams County",17,001,000202,Illinois
4,1594,1245,349,1400000US17001000400,"Census Tract 4,Adams County",17,001,000400,Illinois
5,929,779,150,1400000US17001000500,"Census Tract 5,Adams County",17,001,000500,Illinois
6,1974,1915,59,1400000US17001000600,"Census Tract 6,Adams County",17,001,000600,Illinois
7,1022,746,276,1400000US17001000700,"Census Tract 7,Adams County",17,001,000700,Illinois
8,1265,1035,230,1400000US17001000800,"Census Tract 8,Adams County",17,001,000800,Illinois
9,1358,1200,158,1400000US17001000900,"Census Tract 9,Adams County",17,001,000900,Illinois
10,1443,1367,76,1400000US17001001001,"Census Tract 10,01,Adams County",17,001,001001,Illinois
11,1260,1187,73,1400000US17001001002,"Census Tract 10,02,Adams County",17,001,001002,Illinois
12,3432,3325,107,1400000US17001001100,"Census Tract 11,Adams County",17,001,001100,Illinois
13,2017,1765,252,1400000US17001010100,"Census Tract 101,Adams County",17,001,010100,Illinois
14,1693,1536,157,1400000US17001010200,"Census Tract 102,Adams County",17,001,010200,Illinois
15,1124,988,136,1400000US17001010301,"Census Tract 103,01,Adams County",17,001,010301,Illinois
16,1201,1100,101,1400000US17001010302,"Census Tract 103,02,Adams County",17,001,010302,Illinois
17,1444,1297,147,1400000US17001010400,"Census Tract 104,Adams County",17,001,010400,Illinois
18,1290,1181,109,1400000US17001010500,"Census Tract 105,Adams County",17,001,010500,Illinois
19,2753,2385,368,1400000US17001010600,"Census Tract 106,Adams County",17,001,010600,Illinois
20,888,616,272,1400000US17003957600,"Census Tract 9576,Alexander County",17,003,957600,Illinois
21,761,484,277,1400000US17003957700,"Census Tract 9577,Alexander County",17,003,957700,Illinois
22,705,373,332,1400000US17003957800,"Census Tract 9578,Alexander County",17,003,957800,Illinois
23,705,308,397,1400000US17003957900,"Census Tract 9579,Alexander County",17,003,957900,Illinois
24,1546,1294,252,1400000US17005951200,"Census Tract 9512,Bond County",17,005,951200,Illinois
25,2294,2052,242,1400000US17005951300,"Census Tract 9513,Bond County",17,005,951300,Illinois
26,1173,1066,107,1400000US17005951400,"Census Tract 9514,Bond County",17,005,951400,Illinois
27,1889,1682,207,1400000US17005951500,"Census Tract 9515,Bond County",17,005,951500,Illinois
28,1515,1418,97,1400000US17007010101,"Census Tract 101,01,Boone County",17,007,010101,Illinois
29,1503,1304,199,1400000US17007010102,"Census Tract 101,02,Boone County",17,007,010102,Illinois
30,2347,2171,176,1400000US17007010200,"Census Tract 102,Boone County",17,007,010200,Illinois
31,2713,2713,0,1400000US17007010300,"Census Tract 103,Boone County",17,007,010300,Illinois
32,2687,2588,99,1400000US17007010400,"Census Tract 104,Boone County",17,007,010400,Illinois
33,1704,1591,113,1400000US17007010501,"Census Tract 105,01,Boone County",17,007,010501,Illinois
34,2104,1994,110,1400000US17007010502,"Census Tract 105,02,Boone County",17,007,010502,Illinois
35,1487,1310,177,1400000US17007010601,"Census Tract 106,01,Boone County",17,007,010601,Illinois
36,2125,2015,110,1400000US17007010603,"Census Tract 106,03,Boone County",17,007,010603,Illinois
37,1953,1793,160,1400000US17007010604,"Census Tract 106,04,Boone County",17,007,010604,Illinois
38,1254,1007,247,1400000US17009970400,"Census Tract 9704,Brown County",17,009,970400,Illinois
39,1092,991,101,1400000US17009970500,"Census Tract 9705,Brown County",17,009,970500,Illinois
40,1264,1126,138,1400000US17011964700,"Census Tract 9647,Bureau County",17,011,964700,Illinois
41,1493,1242,251,1400000US17011964800,"Census Tract 9648,Bureau County",17,011,964800,Illinois
42,1261,1138,123,1400000US17011964900,"Census Tract 9649,Bureau County",17,011,964900,Illinois
43,1602,1368,234,1400000US17011965000,"Census Tract 9650,Bureau County",17,011,965000,Illinois
44,1841,1577,264,1400000US17011965100,"Census Tract 9651,Bureau County",17,011,965100,Illinois
45,1620,1620,0,1400000US17011965200,"Census Tract 9652,Bureau County",17,011,965200,Illinois
46,1551,1356,195,1400000US17011965300,"Census Tract 9653,Bureau County",17,011,965300,Illinois
47,1999,1746,253,1400000US17011965400,"Census Tract 9654,Bureau County",17,011,965400,Illinois
48,1658,1471,187,1400000US17011965500,"Census Tract 9655,Bureau County",17,011,965500,Illinois
49,1326,1144,182,1400000US17011965600,"Census Tract 9656,Bureau County",17,011,965600,Illinois
50,1223,623,600,1400000US17013951200,"Census Tract 9512,Calhoun County",17,013,951200,Illinois
51,1121,649,472,1400000US17013951300,"Census Tract 9513,Calhoun County",17,013,951300,Illinois
52,2241,1395,846,1400000US17015960100,"Census Tract 9601,Carroll County",17,015,960100,Illinois
53,1291,957,334,1400000US17015960200,"Census Tract 9602,Carroll County",17,015,960200,Illinois
54,1716,1432,284,1400000US17015960300,"Census Tract 9603,Carroll County",17,015,960300,Illinois
55,1013,806,207,1400000US17015960400,"Census Tract 9604,Carroll County",17,015,960400,Illinois
56,1160,1036,124,1400000US17015960500,"Census Tract 9605,Carroll County",17,015,960500,Illinois
57,774,673,101,1400000US17015960600,"Census Tract 9606,Carroll County",17,015,960600,Illinois
58,1099,903,196,1400000US17017960100,"Census Tract 9601,Cass County",17,017,960100,Illinois
59,1129,1020,109,1400000US17017960200,"Census Tract 9602,Cass County",17,017,960200,Illinois
60,1265,1090,175,1400000US17017960300,"Census Tract 9603,Cass County",17,017,960300,Illinois
61,1131,1062,69,1400000US17017960400,"Census Tract 9604,Cass County",17,017,960400,Illinois
62,1078,908,170,1400000US17017960500,"Census Tract 9605,Cass County",17,017,960500,Illinois
63,1113,921,192,1400000US17019000200,"Census Tract 2,Champaign County",17,019,000200,Illinois
64,2866,2163,703,1400000US17019000301,"Census Tract 3,01,Champaign County",17,019,000301,Illinois
65,2371,1616,755,1400000US17019000302,"Census Tract 3,02,Champaign County",17,019,000302,Illinois
66,742,543,199,1400000US17019000401,"Census Tract 4,01,Champaign County",17,019,000401,Illinois
67,1696,1140,556,1400000US17019000402,"Census Tract 4,02,Champaign County",17,019,000402,Illinois
68,1991,1847,144,1400000US17019000500,"Census Tract 5,Champaign County",17,019,000500,Illinois
69,1563,1392,171,1400000US17019000700,"Census Tract 7,Champaign County",17,019,000700,Illinois
70,3058,2930,128,1400000US17019000800,"Census Tract 8,Champaign County",17,019,000800,Illinois
71,2204,1867,337,1400000US17019000901,"Census Tract 9,01,Champaign County",17,019,000901,Illinois
72,3027,2893,134,1400000US17019000902,"Census Tract 9,02,Champaign County",17,019,000902,Illinois
73,2589,2111,478,1400000US17019001000,"Census Tract 10,Champaign County",17,019,001000,Illinois
74,1679,1623,56,1400000US17019001100,"Census Tract 11,Champaign County",17,019,001100,Illinois
75,3301,2953,348,1400000US17019001201,"Census Tract 12,01,Champaign County",17,019,001201,Illinois
76,1976,1915,61,1400000US17019001203,"Census Tract 12,03,Champaign County",17,019,001203,Illinois
77,1440,1353,87,1400000US17019001204,"Census Tract 12,04,Champaign County",17,019,001204,Illinois
78,3514,3269,245,1400000US17019001205,"Census Tract 12,05,Champaign County",17,019,001205,Illinois
79,960,893,67,1400000US17019001206,"Census Tract 12,06,Champaign County",17,019,001206,Illinois
80,2959,2706,253,1400000US17019001301,"Census Tract 13,01,Champaign County",17,019,001301,Illinois
81,2183,2030,153,1400000US17019001302,"Census Tract 13,02,Champaign County",17,019,001302,Illinois
82,1711,1590,121,1400000US17019001400,"Census Tract 14,Champaign County",17,019,001400,Illinois
83,3093,2350,743,1400000US17019005300,"Census Tract 53,Champaign County",17,019,005300,Illinois
84,2450,2189,261,1400000US17019005401,"Census Tract 54,01,Champaign County",17,019,005401,Illinois
85,1789,1715,74,1400000US17019005402,"Census Tract 54,02,Champaign County",17,019,005402,Illinois
86,2554,2093,461,1400000US17019005500,"Census Tract 55,Champaign County",17,019,005500,Illinois
87,2629,2475,154,1400000US17019005601,"Census Tract 56,01,Champaign County",17,019,005601,Illinois
88,1249,1216,33,1400000US17019005602,"Census Tract 56,02,Champaign County",17,019,005602,Illinois
89,2554,2320,234,1400000US17019005701,"Census Tract 57,01,Champaign County",17,019,005701,Illinois
90,707,682,25,1400000US17019005702,"Census Tract 57,02,Champaign County",17,019,005702,Illinois
91,1681,1460,221,1400000US17019005800,"Census Tract 58,Champaign County",17,019,005800,Illinois
92,469,394,75,1400000US17019005901,"Census Tract 59,01,Champaign County",17,019,005901,Illinois
93,902,645,257,1400000US17019005902,"Census Tract 59,02,Champaign County",17,019,005902,Illinois
94,763,614,149,1400000US17019006000,"Census Tract 60,Champaign County",17,019,006000,Illinois
95,2270,1942,328,1400000US17019010100,"Census Tract 101,Champaign County",17,019,010100,Illinois
96,2364,1993,371,1400000US17019010204,"Census Tract 102,04,Champaign County",17,019,010204,Illinois
97,1398,1198,200,1400000US17019010300,"Census Tract 103,Champaign County",17,019,010300,Illinois
98,2012,1773,239,1400000US17019010400,"Census Tract 104,Champaign County",17,019,010400,Illinois
99,1677,1589,88,1400000US17019010500,"Census Tract 105,Champaign County",17,019,010500,Illinois
100,2108,2069,39,1400000US17019010601,"Census Tract 106,01,Champaign County",17,019,010601,Illinois
101,2996,2535,461,1400000US17019010603,"Census Tract 106,03,Champaign County",17,019,010603,Illinois
102,1311,1197,114,1400000US17019010604,"Census Tract 106,04,Champaign County",17,019,010604,Illinois
103,1443,1443,0,1400000US17019010701,"Census Tract 107,01,Champaign County",17,019,010701,Illinois
104,1565,1461,104,1400000US17019010702,"Census Tract 107,02,Champaign County",17,019,010702,Illinois
105,1819,1676,143,1400000US17019010800,"Census Tract 108,Champaign County",17,019,010800,Illinois
106,2463,2325,138,1400000US17019010901,"Census Tract 109,01,Champaign County",17,019,010901,Illinois
107,1662,1486,176,1400000US17019010902,"Census Tract 109,02,Champaign County",17,019,010902,Illinois
108,1316,1219,97,1400000US17019011001,"Census Tract 110,01,Champaign County",17,019,011001,Illinois
109,1227,1083,144,1400000US17019011002,"Census Tract 110,02,Champaign County",17,019,011002,Illinois
110,1249,938,311,1400000US17019011100,"Census Tract 111,Champaign County",17,019,011100,Illinois
111,1328,1180,148,1400000US17021958100,"Census Tract 9581,Christian County",17,021,958100,Illinois
112,1656,1532,124,1400000US17021958200,"Census Tract 9582,Christian County",17,021,958200,Illinois
113,2093,1966,127,1400000US17021958300,"Census Tract 9583,Christian County",17,021,958300,Illinois
114,1826,1486,340,1400000US17021958400,"Census Tract 9584,Christian County",17,021,958400,Illinois
115,1214,1057,157,1400000US17021958500,"Census Tract 9585,Christian County",17,021,958500,Illinois
116,1027,949,78,1400000US17021958600,"Census Tract 9586,Christian County",17,021,958600,Illinois
117,1580,1419,161,1400000US17021958700,"Census Tract 9587,Christian County",17,021,958700,Illinois
118,1259,1091,168,1400000US17021958800,"Census Tract 9588,Christian County",17,021,958800,Illinois
119,1281,1051,230,1400000US17021958900,"Census Tract 9589,Christian County",17,021,958900,Illinois
120,1978,1836,142,1400000US17021959000,"Census Tract 9590,Christian County",17,021,959000,Illinois
121,2043,1733,310,1400000US17023060100,"Census Tract 601,Clark County",17,023,060100,Illinois
122,2014,1738,276,1400000US17023060200,"Census Tract 602,Clark County",17,023,060200,Illinois
123,2539,2186,353,1400000US17023060300,"Census Tract 603,Clark County",17,023,060300,Illinois
124,782,722,60,1400000US17023060400,"Census Tract 604,Clark County",17,023,060400,Illinois
125,1111,950,161,1400000US17025971900,"Census Tract 9719,Clay County",17,025,971900,Illinois
126,1274,1163,111,1400000US17025972000,"Census Tract 9720,Clay County",17,025,972000,Illinois
127,2475,2228,247,1400000US17025972100,"Census Tract 9721,Clay County",17,025,972100,Illinois
128,1311,1106,205,1400000US17025972200,"Census Tract 9722,Clay County",17,025,972200,Illinois
129,2612,2499,113,1400000US17027900100,"Census Tract 9001,Clinton County",17,027,900100,Illinois
130,740,658,82,1400000US17027900200,"Census Tract 9002,Clinton County",17,027,900200,Illinois
131,2856,2800,56,1400000US17027900300,"Census Tract 9003,Clinton County",17,027,900300,Illinois
132,631,543,88,1400000US17027900401,"Census Tract 9004,01,Clinton County",17,027,900401,Illinois
133,1656,1545,111,1400000US17027900403,"Census Tract 9004,03,Clinton County",17,027,900403,Illinois
134,899,488,411,1400000US17027900404,"Census Tract 9004,04,Clinton County",17,027,900404,Illinois
135,2055,1812,243,1400000US17027900500,"Census Tract 9005,Clinton County",17,027,900500,Illinois
136,1199,1171,28,1400000US17027900601,"Census Tract 9006,01,Clinton County",17,027,900601,Illinois
137,2927,2739,188,1400000US17027900602,"Census Tract 9006,02,Clinton County",17,027,900602,Illinois
138,1281,1165,116,1400000US17029000100,"Census Tract 1,Coles County",17,029,000100,Illinois
139,2288,2069,219,1400000US17029000200,"Census Tract 2,Coles County",17,029,000200,Illinois
140,2261,2100,161,1400000US17029000300,"Census Tract 3,Coles County",17,029,000300,Illinois
141,1574,1464,110,1400000US17029000400,"Census Tract 4,Coles County",17,029,000400,Illinois
142,2786,2463,323,1400000US17029000500,"Census Tract 5,Coles County",17,029,000500,Illinois
143,1527,1340,187,1400000US17029000600,"Census Tract 6,Coles County",17,029,000600,Illinois
144,1540,1236,304,1400000US17029000701,"Census Tract 7,01,Coles County",17,029,000701,Illinois
145,1902,1609,293,1400000US17029000702,"Census Tract 7,02,Coles County",17,029,000702,Illinois
146,922,606,316,1400000US17029000800,"Census Tract 8,Coles County",17,029,000800,Illinois
147,1756,1665,91,1400000US17029000900,"Census Tract 9,Coles County",17,029,000900,Illinois
148,1559,1490,69,1400000US17029001000,"Census Tract 10,Coles County",17,029,001000,Illinois
149,1695,1584,111,1400000US17029001100,"Census Tract 11,Coles County",17,029,001100,Illinois
150,1761,1478,283,1400000US17029001200,"Census Tract 12,Coles County",17,029,001200,Illinois
151,2935,2411,524,1400000US17031010100,"Census Tract 101,Cook County",17,031,010100,Illinois
152,3217,2996,221,1400000US17031010201,"Census Tract 102,01,Cook County",17,031,010201,Illinois
153,1298,1234,64,1400000US17031010202,"Census Tract 102,02,Cook County",17,031,010202,Illinois
154,3363,2995,368,1400000US17031010300,"Census Tract 103,Cook County",17,031,010300,Illinois
155,2379,2034,345,1400000US17031010400,"Census Tract 104,Cook County",17,031,010400,Illinois
156,2691,2439,252,1400000US17031010501,"Census Tract 105,01,Cook County",17,031,010501,Illinois
157,1793,1539,254,1400000US17031010502,"Census Tract 105,02,Cook County",17,031,010502,Illinois
158,1411,1155,256,1400000US17031010503,"Census Tract 105,03,Cook County",17,031,010503,Illinois
159,3168,2917,251,1400000US17031010600,"Census Tract 106,Cook County",17,031,010600,Illinois
160,1750,1564,186,1400000US17031010701,"Census Tract 107,01,Cook County",17,031,010701,Illinois
161,2105,1845,260,1400000US17031010702,"Census Tract 107,02,Cook County",17,031,010702,Illinois
162,1697,1624,73,1400000US17031020100,"Census Tract 201,Cook County",17,031,020100,Illinois
163,2211,2037,174,1400000US17031020200,"Census Tract 202,Cook County",17,031,020200,Illinois
164,2273,2197,76,1400000US17031020301,"Census Tract 203,01,Cook County",17,031,020301,Illinois
165,1864,1699,165,1400000US17031020302,"Census Tract 203,02,Cook County",17,031,020302,Illinois
166,1895,1710,185,1400000US17031020400,"Census Tract 204,Cook County",17,031,020400,Illinois
167,2443,2160,283,1400000US17031020500,"Census Tract 205,Cook County",17,031,020500,Illinois
168,2233,2051,182,1400000US17031020601,"Census Tract 206,01,Cook County",17,031,020601,Illinois
169,1733,1672,61,1400000US17031020602,"Census Tract 206,02,Cook County",17,031,020602,Illinois
170,823,762,61,1400000US17031020701,"Census Tract 207,01,Cook County",17,031,020701,Illinois
171,2570,2458,112,1400000US17031020702,"Census Tract 207,02,Cook County",17,031,020702,Illinois
172,2437,2207,230,1400000US17031020801,"Census Tract 208,01,Cook County",17,031,020801,Illinois
173,2377,2077,300,1400000US17031020802,"Census Tract 208,02,Cook County",17,031,020802,Illinois
174,2468,2200,268,1400000US17031020901,"Census Tract 209,01,Cook County",17,031,020901,Illinois
175,1775,1587,188,1400000US17031020902,"Census Tract 209,02,Cook County",17,031,020902,Illinois
176,2409,2106,303,1400000US17031030101,"Census Tract 301,01,Cook County",17,031,030101,Illinois
177,2145,1847,298,1400000US17031030102,"Census Tract 301,02,Cook County",17,031,030102,Illinois
178,1181,1014,167,1400000US17031030103,"Census Tract 301,03,Cook County",17,031,030103,Illinois
179,1145,987,158,1400000US17031030104,"Census Tract 301,04,Cook County",17,031,030104,Illinois
180,2747,2550,197,1400000US17031030200,"Census Tract 302,Cook County",17,031,030200,Illinois
181,1513,1493,20,1400000US17031030300,"Census Tract 303,Cook County",17,031,030300,Illinois
182,1362,1285,77,1400000US17031030400,"Census Tract 304,Cook County",17,031,030400,Illinois
183,3280,2965,315,1400000US17031030500,"Census Tract 305,Cook County",17,031,030500,Illinois
184,2176,1921,255,1400000US17031030601,"Census Tract 306,01,Cook County",17,031,030601,Illinois
185,1595,1414,181,1400000US17031030603,"Census Tract 306,03,Cook County",17,031,030603,Illinois
186,2495,2127,368,1400000US17031030604,"Census Tract 306,04,Cook County",17,031,030604,Illinois
187,959,844,115,1400000US17031030701,"Census Tract 307,01,Cook County",17,031,030701,Illinois
188,1670,1489,181,1400000US17031030702,"Census Tract 307,02,Cook County",17,031,030702,Illinois
189,2084,1907,177,1400000US17031030703,"Census Tract 307,03,Cook County",17,031,030703,Illinois
190,2174,1905,269,1400000US17031030706,"Census Tract 307,06,Cook County",17,031,030706,Illinois
191,2363,2138,225,1400000US17031030800,"Census Tract 308,Cook County",17,031,030800,Illinois
192,1667,1484,183,1400000US17031030900,"Census Tract 309,Cook County",17,031,030900,Illinois
193,2152,2062,90,1400000US17031031000,"Census Tract 310,Cook County",17,031,031000,Illinois
194,2868,2737,131,1400000US17031031100,"Census Tract 311,Cook County",17,031,031100,Illinois
195,3551,3263,288,1400000US17031031200,"Census Tract 312,Cook County",17,031,031200,Illinois
196,4844,4469,375,1400000US17031031300,"Census Tract 313,Cook County",17,031,031300,Illinois
197,3724,3117,607,1400000US17031031400,"Census Tract 314,Cook County",17,031,031400,Illinois
198,2080,1961,119,1400000US17031031501,"Census Tract 315,01,Cook County",17,031,031501,Illinois
199,2623,2449,174,1400000US17031031502,"Census Tract 315,02,Cook County",17,031,031502,Illinois
200,3711,3280,431,1400000US17031031700,"Census Tract 317,Cook County",17,031,031700,Illinois
201,1060,1005,55,1400000US17031031800,"Census Tract 318,Cook County",17,031,031800,Illinois
202,1397,1347,50,1400000US17031031900,"Census Tract 319,Cook County",17,031,031900,Illinois
203,4530,4207,323,1400000US17031032100,"Census Tract 321,Cook County",17,031,032100,Illinois
204,1920,1810,110,1400000US17031040100,"Census Tract 401,Cook County",17,031,040100,Illinois
205,3138,3033,105,1400000US17031040201,"Census Tract 402,01,Cook County",17,031,040201,Illinois
206,3105,2876,229,1400000US17031040202,"Census Tract 402,02,Cook County",17,031,040202,Illinois
207,1140,1125,15,1400000US17031040300,"Census Tract 403,Cook County",17,031,040300,Illinois
208,1566,1450,116,1400000US17031040401,"Census Tract 404,01,Cook County",17,031,040401,Illinois
209,2725,2424,301,1400000US17031040402,"Census Tract 404,02,Cook County",17,031,040402,Illinois
210,1353,1253,100,1400000US17031040600,"Census Tract 406,Cook County",17,031,040600,Illinois
211,1749,1646,103,1400000US17031040700,"Census Tract 407,Cook County",17,031,040700,Illinois
212,895,785,110,1400000US17031040800,"Census Tract 408,Cook County",17,031,040800,Illinois
213,1219,1108,111,1400000US17031040900,"Census Tract 409,Cook County",17,031,040900,Illinois
214,1239,1173,66,1400000US17031050100,"Census Tract 501,Cook County",17,031,050100,Illinois
215,2341,2082,259,1400000US17031050200,"Census Tract 502,Cook County",17,031,050200,Illinois
216,1180,1091,89,1400000US17031050300,"Census Tract 503,Cook County",17,031,050300,Illinois
217,2437,2054,383,1400000US17031050500,"Census Tract 505,Cook County",17,031,050500,Illinois
218,1155,1121,34,1400000US17031050600,"Census Tract 506,Cook County",17,031,050600,Illinois
219,765,692,73,1400000US17031050700,"Census Tract 507,Cook County",17,031,050700,Illinois
220,593,535,58,1400000US17031050800,"Census Tract 508,Cook County",17,031,050800,Illinois
221,724,648,76,1400000US17031050900,"Census Tract 509,Cook County",17,031,050900,Illinois
222,789,707,82,1400000US17031051000,"Census Tract 510,Cook County",17,031,051000,Illinois
223,828,753,75,1400000US17031051100,"Census Tract 511,Cook County",17,031,051100,Illinois
224,658,613,45,1400000US17031051200,"Census Tract 512,Cook County",17,031,051200,Illinois
225,1118,1091,27,1400000US17031051300,"Census Tract 513,Cook County",17,031,051300,Illinois
226,1210,981,229,1400000US17031051400,"Census Tract 514,Cook County",17,031,051400,Illinois
227,1415,1346,69,1400000US17031060100,"Census Tract 601,Cook County",17,031,060100,Illinois
228,1169,1101,68,1400000US17031060200,"Census Tract 602,Cook County",17,031,060200,Illinois
229,1253,1216,37,1400000US17031060300,"Census Tract 603,Cook County",17,031,060300,Illinois
230,1695,1614,81,1400000US17031060400,"Census Tract 604,Cook County",17,031,060400,Illinois
231,767,679,88,1400000US17031060500,"Census Tract 605,Cook County",17,031,060500,Illinois
232,3792,3555,237,1400000US17031060800,"Census Tract 608,Cook County",17,031,060800,Illinois
233,5153,4794,359,1400000US17031060900,"Census Tract 609,Cook County",17,031,060900,Illinois
234,1206,1159,47,1400000US17031061000,"Census Tract 610,Cook County",17,031,061000,Illinois
235,801,713,88,1400000US17031061100,"Census Tract 611,Cook County",17,031,061100,Illinois
236,959,821,138,1400000US17031061200,"Census Tract 612,Cook County",17,031,061200,Illinois
237,969,899,70,1400000US17031061500,"Census Tract 615,Cook County",17,031,061500,Illinois
238,783,742,41,1400000US17031061800,"Census Tract 618,Cook County",17,031,061800,Illinois
239,2661,2415,246,1400000US17031061901,"Census Tract 619,01,Cook County",17,031,061901,Illinois
240,3023,2882,141,1400000US17031061902,"Census Tract 619,02,Cook County",17,031,061902,Illinois
241,1717,1631,86,1400000US17031062000,"Census Tract 620,Cook County",17,031,062000,Illinois
242,1983,1906,77,1400000US17031062100,"Census Tract 621,Cook County",17,031,062100,Illinois
243,1399,1296,103,1400000US17031062200,"Census Tract 622,Cook County",17,031,062200,Illinois
244,704,637,67,1400000US17031062300,"Census Tract 623,Cook County",17,031,062300,Illinois
245,787,737,50,1400000US17031062400,"Census Tract 624,Cook County",17,031,062400,Illinois
246,796,688,108,1400000US17031062500,"Census Tract 625,Cook County",17,031,062500,Illinois
247,978,952,26,1400000US17031062600,"Census Tract 626,Cook County",17,031,062600,Illinois
248,1381,1265,116,1400000US17031062700,"Census Tract 627,Cook County",17,031,062700,Illinois
249,1694,1433,261,1400000US17031062800,"Census Tract 628,Cook County",17,031,062800,Illinois
250,1953,1820,133,1400000US17031062900,"Census Tract 629,Cook County",17,031,062900,Illinois
251,1931,1808,123,1400000US17031063000,"Census Tract 630,Cook County",17,031,063000,Illinois
252,1400,1384,16,1400000US17031063100,"Census Tract 631,Cook County",17,031,063100,Illinois
253,4758,4392,366,1400000US17031063200,"Census Tract 632,Cook County",17,031,063200,Illinois
254,2117,1998,119,1400000US17031063301,"Census Tract 633,01,Cook County",17,031,063301,Illinois
255,3125,2737,388,1400000US17031063302,"Census Tract 633,02,Cook County",17,031,063302,Illinois
256,1038,857,181,1400000US17031063303,"Census Tract 633,03,Cook County",17,031,063303,Illinois
257,1394,1283,111,1400000US17031063400,"Census Tract 634,Cook County",17,031,063400,Illinois
258,2610,2413,197,1400000US17031070101,"Census Tract 701,01,Cook County",17,031,070101,Illinois
259,2348,2124,224,1400000US17031070102,"Census Tract 701,02,Cook County",17,031,070102,Illinois
260,1185,1105,80,1400000US17031070103,"Census Tract 701,03,Cook County",17,031,070103,Illinois
261,2280,2060,220,1400000US17031070200,"Census Tract 702,Cook County",17,031,070200,Illinois
262,1747,1597,150,1400000US17031070300,"Census Tract 703,Cook County",17,031,070300,Illinois
263,1643,1542,101,1400000US17031070400,"Census Tract 704,Cook County",17,031,070400,Illinois
264,1435,1286,149,1400000US17031070500,"Census Tract 705,Cook County",17,031,070500,Illinois
265,1419,1197,222,1400000US17031070600,"Census Tract 706,Cook County",17,031,070600,Illinois
266,2267,1698,569,1400000US17031070700,"Census Tract 707,Cook County",17,031,070700,Illinois
267,1047,1021,26,1400000US17031071000,"Census Tract 710,Cook County",17,031,071000,Illinois
268,1296,1120,176,1400000US17031071100,"Census Tract 711,Cook County",17,031,071100,Illinois
269,1066,1008,58,1400000US17031071200,"Census Tract 712,Cook County",17,031,071200,Illinois
270,2186,2140,46,1400000US17031071300,"Census Tract 713,Cook County",17,031,071300,Illinois
271,3188,2881,307,1400000US17031071400,"Census Tract 714,Cook County",17,031,071400,Illinois
272,4321,3819,502,1400000US17031071500,"Census Tract 715,Cook County",17,031,071500,Illinois
273,793,755,38,1400000US17031071600,"Census Tract 716,Cook County",17,031,071600,Illinois
274,703,635,68,1400000US17031071700,"Census Tract 717,Cook County",17,031,071700,Illinois
275,1152,1107,45,1400000US17031071800,"Census Tract 718,Cook County",17,031,071800,Illinois
276,4941,4165,776,1400000US17031080100,"Census Tract 801,Cook County",17,031,080100,Illinois
277,2655,2197,458,1400000US17031080201,"Census Tract 802,01,Cook County",17,031,080201,Illinois
278,2832,2507,325,1400000US17031080202,"Census Tract 802,02,Cook County",17,031,080202,Illinois
279,3199,2891,308,1400000US17031080300,"Census Tract 803,Cook County",17,031,080300,Illinois
280,2101,2030,71,1400000US17031080400,"Census Tract 804,Cook County",17,031,080400,Illinois
281,6041,4909,1132,1400000US17031081000,"Census Tract 810,Cook County",17,031,081000,Illinois
282,3228,2924,304,1400000US17031081100,"Census Tract 811,Cook County",17,031,081100,Illinois
283,3846,2952,894,1400000US17031081201,"Census Tract 812,01,Cook County",17,031,081201,Illinois
284,2473,1922,551,1400000US17031081202,"Census Tract 812,02,Cook County",17,031,081202,Illinois
285,4273,3740,533,1400000US17031081300,"Census Tract 813,Cook County",17,031,081300,Illinois
286,1820,1446,374,1400000US17031081401,"Census Tract 814,01,Cook County",17,031,081401,Illinois
287,4252,3322,930,1400000US17031081402,"Census Tract 814,02,Cook County",17,031,081402,Illinois
288,7347,6149,1198,1400000US17031081403,"Census Tract 814,03,Cook County",17,031,081403,Illinois
289,4477,3294,1183,1400000US17031081500,"Census Tract 815,Cook County",17,031,081500,Illinois
290,3054,2461,593,1400000US17031081600,"Census Tract 816,Cook County",17,031,081600,Illinois
291,3678,3206,472,1400000US17031081700,"Census Tract 817,Cook County",17,031,081700,Illinois
292,7694,7037,657,1400000US17031081800,"Census Tract 818,Cook County",17,031,081800,Illinois
293,1102,652,450,1400000US17031081900,"Census Tract 819,Cook County",17,031,081900,Illinois
294,1483,1390,93,1400000US17031090100,"Census Tract 901,Cook County",17,031,090100,Illinois
295,2856,2638,218,1400000US17031090200,"Census Tract 902,Cook County",17,031,090200,Illinois
296,569,526,43,1400000US17031090300,"Census Tract 903,Cook County",17,031,090300,Illinois
297,2326,2176,150,1400000US17031100100,"Census Tract 1001,Cook County",17,031,100100,Illinois
298,2908,2865,43,1400000US17031100200,"Census Tract 1002,Cook County",17,031,100200,Illinois
299,2892,2750,142,1400000US17031100300,"Census Tract 1003,Cook County",17,031,100300,Illinois
300,1291,1291,0,1400000US17031100400,"Census Tract 1004,Cook County",17,031,100400,Illinois
301,2399,2332,67,1400000US17031100500,"Census Tract 1005,Cook County",17,031,100500,Illinois
302,1962,1910,52,1400000US17031100600,"Census Tract 1006,Cook County",17,031,100600,Illinois
303,1924,1883,41,1400000US17031100700,"Census Tract 1007,Cook County",17,031,100700,Illinois
304,2422,2221,201,1400000US17031110100,"Census Tract 1101,Cook County",17,031,110100,Illinois
305,1458,1346,112,1400000US17031110200,"Census Tract 1102,Cook County",17,031,110200,Illinois
306,1961,1815,146,1400000US17031110300,"Census Tract 1103,Cook County",17,031,110300,Illinois
307,2093,1890,203,1400000US17031110400,"Census Tract 1104,Cook County",17,031,110400,Illinois
308,2072,1911,161,1400000US17031110501,"Census Tract 1105,01,Cook County",17,031,110501,Illinois
309,1653,1575,78,1400000US17031110502,"Census Tract 1105,02,Cook County",17,031,110502,Illinois
310,1631,1548,83,1400000US17031120100,"Census Tract 1201,Cook County",17,031,120100,Illinois
311,1842,1769,73,1400000US17031120200,"Census Tract 1202,Cook County",17,031,120200,Illinois
312,2568,2568,0,1400000US17031120300,"Census Tract 1203,Cook County",17,031,120300,Illinois
313,1314,1227,87,1400000US17031120400,"Census Tract 1204,Cook County",17,031,120400,Illinois
314,1917,1842,75,1400000US17031130100,"Census Tract 1301,Cook County",17,031,130100,Illinois
315,763,715,48,1400000US17031130200,"Census Tract 1302,Cook County",17,031,130200,Illinois
316,2023,1834,189,1400000US17031130300,"Census Tract 1303,Cook County",17,031,130300,Illinois
317,1318,1197,121,1400000US17031140100,"Census Tract 1401,Cook County",17,031,140100,Illinois
318,2177,1942,235,1400000US17031140200,"Census Tract 1402,Cook County",17,031,140200,Illinois
319,951,906,45,1400000US17031140301,"Census Tract 1403,01,Cook County",17,031,140301,Illinois
320,1468,1319,149,1400000US17031140302,"Census Tract 1403,02,Cook County",17,031,140302,Illinois
321,2264,2158,106,1400000US17031140400,"Census Tract 1404,Cook County",17,031,140400,Illinois
322,1441,1333,108,1400000US17031140500,"Census Tract 1405,Cook County",17,031,140500,Illinois
323,908,846,62,1400000US17031140601,"Census Tract 1406,01,Cook County",17,031,140601,Illinois
324,1902,1786,116,1400000US17031140602,"Census Tract 1406,02,Cook County",17,031,140602,Illinois
325,1174,1086,88,1400000US17031140701,"Census Tract 1407,01,Cook County",17,031,140701,Illinois
326,2222,2048,174,1400000US17031140702,"Census Tract 1407,02,Cook County",17,031,140702,Illinois
327,2862,2479,383,1400000US17031140800,"Census Tract 1408,Cook County",17,031,140800,Illinois
328,3407,2791,616,1400000US17031150200,"Census Tract 1502,Cook County",17,031,150200,Illinois
329,3329,3052,277,1400000US17031150300,"Census Tract 1503,Cook County",17,031,150300,Illinois
330,1905,1795,110,1400000US17031150401,"Census Tract 1504,01,Cook County",17,031,150401,Illinois
331,1442,1338,104,1400000US17031150402,"Census Tract 1504,02,Cook County",17,031,150402,Illinois
332,1606,1486,120,1400000US17031150501,"Census Tract 1505,01,Cook County",17,031,150501,Illinois
333,1690,1577,113,1400000US17031150502,"Census Tract 1505,02,Cook County",17,031,150502,Illinois
334,1614,1458,156,1400000US17031150600,"Census Tract 1506,Cook County",17,031,150600,Illinois
335,1568,1391,177,1400000US17031150700,"Census Tract 1507,Cook County",17,031,150700,Illinois
336,1813,1665,148,1400000US17031150800,"Census Tract 1508,Cook County",17,031,150800,Illinois
337,999,899,100,1400000US17031151001,"Census Tract 1510,01,Cook County",17,031,151001,Illinois
338,1744,1589,155,1400000US17031151002,"Census Tract 1510,02,Cook County",17,031,151002,Illinois
339,1990,1849,141,1400000US17031151100,"Census Tract 1511,Cook County",17,031,151100,Illinois
340,1361,1297,64,1400000US17031151200,"Census Tract 1512,Cook County",17,031,151200,Illinois
341,1081,1011,70,1400000US17031160100,"Census Tract 1601,Cook County",17,031,160100,Illinois
342,1330,1246,84,1400000US17031160200,"Census Tract 1602,Cook County",17,031,160200,Illinois
343,2062,1767,295,1400000US17031160300,"Census Tract 1603,Cook County",17,031,160300,Illinois
344,2202,1983,219,1400000US17031160400,"Census Tract 1604,Cook County",17,031,160400,Illinois
345,1480,1323,157,1400000US17031160501,"Census Tract 1605,01,Cook County",17,031,160501,Illinois
346,1608,1516,92,1400000US17031160502,"Census Tract 1605,02,Cook County",17,031,160502,Illinois
347,1602,1456,146,1400000US17031160601,"Census Tract 1606,01,Cook County",17,031,160601,Illinois
348,1660,1488,172,1400000US17031160602,"Census Tract 1606,02,Cook County",17,031,160602,Illinois
349,2681,2551,130,1400000US17031160700,"Census Tract 1607,Cook County",17,031,160700,Illinois
350,2047,1874,173,1400000US17031160800,"Census Tract 1608,Cook County",17,031,160800,Illinois
351,1153,1105,48,1400000US17031160900,"Census Tract 1609,Cook County",17,031,160900,Illinois
352,889,807,82,1400000US17031161000,"Census Tract 1610,Cook County",17,031,161000,Illinois
353,804,777,27,1400000US17031161100,"Census Tract 1611,Cook County",17,031,161100,Illinois
354,1140,1080,60,1400000US17031161200,"Census Tract 1612,Cook County",17,031,161200,Illinois
355,1599,1493,106,1400000US17031161300,"Census Tract 1613,Cook County",17,031,161300,Illinois
356,1180,1153,27,1400000US17031170100,"Census Tract 1701,Cook County",17,031,170100,Illinois
357,1285,1243,42,1400000US17031170200,"Census Tract 1702,Cook County",17,031,170200,Illinois
358,1980,1836,144,1400000US17031170300,"Census Tract 1703,Cook County",17,031,170300,Illinois
359,1754,1729,25,1400000US17031170400,"Census Tract 1704,Cook County",17,031,170400,Illinois
360,2108,2049,59,1400000US17031170500,"Census Tract 1705,Cook County",17,031,170500,Illinois
361,1001,967,34,1400000US17031170600,"Census Tract 1706,Cook County",17,031,170600,Illinois
362,1225,1138,87,1400000US17031170700,"Census Tract 1707,Cook County",17,031,170700,Illinois
363,1538,1437,101,1400000US17031170800,"Census Tract 1708,Cook County",17,031,170800,Illinois
364,712,660,52,1400000US17031170900,"Census Tract 1709,Cook County",17,031,170900,Illinois
365,3118,2734,384,1400000US17031171000,"Census Tract 1710,Cook County",17,031,171000,Illinois
366,1377,1349,28,1400000US17031171100,"Census Tract 1711,Cook County",17,031,171100,Illinois
367,2380,2231,149,1400000US17031180100,"Census Tract 1801,Cook County",17,031,180100,Illinois
368,894,831,63,1400000US17031190100,"Census Tract 1901,Cook County",17,031,190100,Illinois
369,1735,1600,135,1400000US17031190200,"Census Tract 1902,Cook County",17,031,190200,Illinois
370,2118,1915,203,1400000US17031190300,"Census Tract 1903,Cook County",17,031,190300,Illinois
371,1375,1307,68,1400000US17031190401,"Census Tract 1904,01,Cook County",17,031,190401,Illinois
372,1911,1796,115,1400000US17031190402,"Census Tract 1904,02,Cook County",17,031,190402,Illinois
373,1196,1091,105,1400000US17031190601,"Census Tract 1906,01,Cook County",17,031,190601,Illinois
374,1684,1581,103,1400000US17031190602,"Census Tract 1906,02,Cook County",17,031,190602,Illinois
375,971,852,119,1400000US17031190701,"Census Tract 1907,01,Cook County",17,031,190701,Illinois
376,1557,1517,40,1400000US17031190702,"Census Tract 1907,02,Cook County",17,031,190702,Illinois
377,2116,1909,207,1400000US17031190800,"Census Tract 1908,Cook County",17,031,190800,Illinois
378,675,618,57,1400000US17031190900,"Census Tract 1909,Cook County",17,031,190900,Illinois
379,791,772,19,1400000US17031191000,"Census Tract 1910,Cook County",17,031,191000,Illinois
380,2105,1923,182,1400000US17031191100,"Census Tract 1911,Cook County",17,031,191100,Illinois
381,1129,1092,37,1400000US17031191200,"Census Tract 1912,Cook County",17,031,191200,Illinois
382,1642,1560,82,1400000US17031191301,"Census Tract 1913,01,Cook County",17,031,191301,Illinois
383,1336,1186,150,1400000US17031191302,"Census Tract 1913,02,Cook County",17,031,191302,Illinois
384,1451,1323,128,1400000US17031200100,"Census Tract 2001,Cook County",17,031,200100,Illinois
385,1737,1633,104,1400000US17031200200,"Census Tract 2002,Cook County",17,031,200200,Illinois
386,744,688,56,1400000US17031200300,"Census Tract 2003,Cook County",17,031,200300,Illinois
387,1013,926,87,1400000US17031200401,"Census Tract 2004,01,Cook County",17,031,200401,Illinois
388,1389,1312,77,1400000US17031200402,"Census Tract 2004,02,Cook County",17,031,200402,Illinois
389,1785,1679,106,1400000US17031210100,"Census Tract 2101,Cook County",17,031,210100,Illinois
390,1036,818,218,1400000US17031210400,"Census Tract 2104,Cook County",17,031,210400,Illinois
391,1577,1336,241,1400000US17031210501,"Census Tract 2105,01,Cook County",17,031,210501,Illinois
392,1793,1572,221,1400000US17031210502,"Census Tract 2105,02,Cook County",17,031,210502,Illinois
393,1218,1139,79,1400000US17031210601,"Census Tract 2106,01,Cook County",17,031,210601,Illinois
394,1770,1504,266,1400000US17031210602,"Census Tract 2106,02,Cook County",17,031,210602,Illinois
395,1587,1452,135,1400000US17031210700,"Census Tract 2107,Cook County",17,031,210700,Illinois
396,457,424,33,1400000US17031210800,"Census Tract 2108,Cook County",17,031,210800,Illinois
397,1496,1401,95,1400000US17031210900,"Census Tract 2109,Cook County",17,031,210900,Illinois
398,1023,905,118,1400000US17031220300,"Census Tract 2203,Cook County",17,031,220300,Illinois
399,1262,1208,54,1400000US17031220400,"Census Tract 2204,Cook County",17,031,220400,Illinois
400,1361,1224,137,1400000US17031220500,"Census Tract 2205,Cook County",17,031,220500,Illinois
401,797,734,63,1400000US17031220601,"Census Tract 2206,01,Cook County",17,031,220601,Illinois
402,2872,2649,223,1400000US17031220602,"Census Tract 2206,02,Cook County",17,031,220602,Illinois
403,1225,1111,114,1400000US17031220701,"Census Tract 2207,01,Cook County",17,031,220701,Illinois
404,1738,1641,97,1400000US17031220702,"Census Tract 2207,02,Cook County",17,031,220702,Illinois
405,1171,1054,117,1400000US17031220901,"Census Tract 2209,01,Cook County",17,031,220901,Illinois
406,1124,990,134,1400000US17031220902,"Census Tract 2209,02,Cook County",17,031,220902,Illinois
407,1163,1063,100,1400000US17031221000,"Census Tract 2210,Cook County",17,031,221000,Illinois
408,2259,2011,248,1400000US17031221100,"Census Tract 2211,Cook County",17,031,221100,Illinois
409,1333,1226,107,1400000US17031221200,"Census Tract 2212,Cook County",17,031,221200,Illinois
410,1620,1444,176,1400000US17031221300,"Census Tract 2213,Cook County",17,031,221300,Illinois
411,1694,1523,171,1400000US17031221400,"Census Tract 2214,Cook County",17,031,221400,Illinois
412,1587,1365,222,1400000US17031221500,"Census Tract 2215,Cook County",17,031,221500,Illinois
413,1581,1417,164,1400000US17031221600,"Census Tract 2216,Cook County",17,031,221600,Illinois
414,1055,1008,47,1400000US17031222200,"Census Tract 2222,Cook County",17,031,222200,Illinois
415,624,563,61,1400000US17031222500,"Census Tract 2225,Cook County",17,031,222500,Illinois
416,823,781,42,1400000US17031222600,"Census Tract 2226,Cook County",17,031,222600,Illinois
417,893,838,55,1400000US17031222700,"Census Tract 2227,Cook County",17,031,222700,Illinois
418,457,407,50,1400000US17031222800,"Census Tract 2228,Cook County",17,031,222800,Illinois
419,428,369,59,1400000US17031222900,"Census Tract 2229,Cook County",17,031,222900,Illinois
420,709,657,52,1400000US17031230100,"Census Tract 2301,Cook County",17,031,230100,Illinois
421,742,695,47,1400000US17031230200,"Census Tract 2302,Cook County",17,031,230200,Illinois
422,295,249,46,1400000US17031230300,"Census Tract 2303,Cook County",17,031,230300,Illinois
423,802,756,46,1400000US17031230400,"Census Tract 2304,Cook County",17,031,230400,Illinois
424,1387,1266,121,1400000US17031230500,"Census Tract 2305,Cook County",17,031,230500,Illinois
425,2115,1995,120,1400000US17031230600,"Census Tract 2306,Cook County",17,031,230600,Illinois
426,2021,1940,81,1400000US17031230700,"Census Tract 2307,Cook County",17,031,230700,Illinois
427,379,326,53,1400000US17031230800,"Census Tract 2308,Cook County",17,031,230800,Illinois
428,2188,2005,183,1400000US17031230900,"Census Tract 2309,Cook County",17,031,230900,Illinois
429,442,410,32,1400000US17031231100,"Census Tract 2311,Cook County",17,031,231100,Illinois
430,2268,2050,218,1400000US17031231200,"Census Tract 2312,Cook County",17,031,231200,Illinois
431,2599,2149,450,1400000US17031231500,"Census Tract 2315,Cook County",17,031,231500,Illinois
432,805,805,0,1400000US17031240200,"Census Tract 2402,Cook County",17,031,240200,Illinois
433,747,615,132,1400000US17031240300,"Census Tract 2403,Cook County",17,031,240300,Illinois
434,1301,1301,0,1400000US17031240500,"Census Tract 2405,Cook County",17,031,240500,Illinois
435,656,656,0,1400000US17031240600,"Census Tract 2406,Cook County",17,031,240600,Illinois
436,712,712,0,1400000US17031240700,"Census Tract 2407,Cook County",17,031,240700,Illinois
437,695,625,70,1400000US17031240800,"Census Tract 2408,Cook County",17,031,240800,Illinois
438,614,539,75,1400000US17031240900,"Census Tract 2409,Cook County",17,031,240900,Illinois
439,917,796,121,1400000US17031241000,"Census Tract 2410,Cook County",17,031,241000,Illinois
440,1726,1486,240,1400000US17031241100,"Census Tract 2411,Cook County",17,031,241100,Illinois
441,939,836,103,1400000US17031241200,"Census Tract 2412,Cook County",17,031,241200,Illinois
442,833,770,63,1400000US17031241300,"Census Tract 2413,Cook County",17,031,241300,Illinois
443,2664,2602,62,1400000US17031241400,"Census Tract 2414,Cook County",17,031,241400,Illinois
444,1430,1260,170,1400000US17031241500,"Census Tract 2415,Cook County",17,031,241500,Illinois
445,1690,1626,64,1400000US17031241600,"Census Tract 2416,Cook County",17,031,241600,Illinois
446,2295,2070,225,1400000US17031242000,"Census Tract 2420,Cook County",17,031,242000,Illinois
447,2079,1971,108,1400000US17031242100,"Census Tract 2421,Cook County",17,031,242100,Illinois
448,2034,1840,194,1400000US17031242200,"Census Tract 2422,Cook County",17,031,242200,Illinois
449,1858,1749,109,1400000US17031242300,"Census Tract 2423,Cook County",17,031,242300,Illinois
450,1633,1477,156,1400000US17031242400,"Census Tract 2424,Cook County",17,031,242400,Illinois
451,1729,1582,147,1400000US17031242500,"Census Tract 2425,Cook County",17,031,242500,Illinois
452,2661,2499,162,1400000US17031242600,"Census Tract 2426,Cook County",17,031,242600,Illinois
453,854,808,46,1400000US17031242700,"Census Tract 2427,Cook County",17,031,242700,Illinois
454,706,660,46,1400000US17031242800,"Census Tract 2428,Cook County",17,031,242800,Illinois
455,928,802,126,1400000US17031242900,"Census Tract 2429,Cook County",17,031,242900,Illinois
456,1158,1079,79,1400000US17031243000,"Census Tract 2430,Cook County",17,031,243000,Illinois
457,1029,944,85,1400000US17031243100,"Census Tract 2431,Cook County",17,031,243100,Illinois
458,1131,1008,123,1400000US17031243200,"Census Tract 2432,Cook County",17,031,243200,Illinois
459,1342,1241,101,1400000US17031243300,"Census Tract 2433,Cook County",17,031,243300,Illinois
460,1542,1377,165,1400000US17031243400,"Census Tract 2434,Cook County",17,031,243400,Illinois
461,2394,2228,166,1400000US17031243500,"Census Tract 2435,Cook County",17,031,243500,Illinois
462,917,858,59,1400000US17031250200,"Census Tract 2502,Cook County",17,031,250200,Illinois
463,1752,1534,218,1400000US17031250300,"Census Tract 2503,Cook County",17,031,250300,Illinois
464,2391,2020,371,1400000US17031250400,"Census Tract 2504,Cook County",17,031,250400,Illinois
465,3063,2770,293,1400000US17031250500,"Census Tract 2505,Cook County",17,031,250500,Illinois
466,1416,1292,124,1400000US17031250600,"Census Tract 2506,Cook County",17,031,250600,Illinois
467,2555,2216,339,1400000US17031250700,"Census Tract 2507,Cook County",17,031,250700,Illinois
468,888,777,111,1400000US17031250800,"Census Tract 2508,Cook County",17,031,250800,Illinois
469,416,382,34,1400000US17031251000,"Census Tract 2510,Cook County",17,031,251000,Illinois
470,1848,1709,139,1400000US17031251100,"Census Tract 2511,Cook County",17,031,251100,Illinois
471,1371,1241,130,1400000US17031251200,"Census Tract 2512,Cook County",17,031,251200,Illinois
472,1843,1455,388,1400000US17031251300,"Census Tract 2513,Cook County",17,031,251300,Illinois
473,2253,2038,215,1400000US17031251400,"Census Tract 2514,Cook County",17,031,251400,Illinois
474,1542,1299,243,1400000US17031251500,"Census Tract 2515,Cook County",17,031,251500,Illinois
475,1449,1234,215,1400000US17031251600,"Census Tract 2516,Cook County",17,031,251600,Illinois
476,483,414,69,1400000US17031251700,"Census Tract 2517,Cook County",17,031,251700,Illinois
477,1981,1624,357,1400000US17031251800,"Census Tract 2518,Cook County",17,031,251800,Illinois
478,2528,2214,314,1400000US17031251900,"Census Tract 2519,Cook County",17,031,251900,Illinois
479,2767,2502,265,1400000US17031252000,"Census Tract 2520,Cook County",17,031,252000,Illinois
480,792,690,102,1400000US17031252101,"Census Tract 2521,01,Cook County",17,031,252101,Illinois
481,2452,2190,262,1400000US17031252102,"Census Tract 2521,02,Cook County",17,031,252102,Illinois
482,1195,1002,193,1400000US17031252201,"Census Tract 2522,01,Cook County",17,031,252201,Illinois
483,1929,1718,211,1400000US17031252202,"Census Tract 2522,02,Cook County",17,031,252202,Illinois
484,729,539,190,1400000US17031260100,"Census Tract 2601,Cook County",17,031,260100,Illinois
485,476,369,107,1400000US17031260200,"Census Tract 2602,Cook County",17,031,260200,Illinois
486,684,569,115,1400000US17031260300,"Census Tract 2603,Cook County",17,031,260300,Illinois
487,582,480,102,1400000US17031260400,"Census Tract 2604,Cook County",17,031,260400,Illinois
488,762,594,168,1400000US17031260500,"Census Tract 2605,Cook County",17,031,260500,Illinois
489,925,611,314,1400000US17031260600,"Census Tract 2606,Cook County",17,031,260600,Illinois
490,724,555,169,1400000US17031260700,"Census Tract 2607,Cook County",17,031,260700,Illinois
491,1011,770,241,1400000US17031260800,"Census Tract 2608,Cook County",17,031,260800,Illinois
492,588,397,191,1400000US17031260900,"Census Tract 2609,Cook County",17,031,260900,Illinois
493,1147,936,211,1400000US17031261000,"Census Tract 2610,Cook County",17,031,261000,Illinois
494,692,591,101,1400000US17031270500,"Census Tract 2705,Cook County",17,031,270500,Illinois
495,460,375,85,1400000US17031271200,"Census Tract 2712,Cook County",17,031,271200,Illinois
496,421,343,78,1400000US17031271300,"Census Tract 2713,Cook County",17,031,271300,Illinois
497,609,526,83,1400000US17031271400,"Census Tract 2714,Cook County",17,031,271400,Illinois
498,565,528,37,1400000US17031271500,"Census Tract 2715,Cook County",17,031,271500,Illinois
499,286,206,80,1400000US17031271800,"Census Tract 2718,Cook County",17,031,271800,Illinois
500,4971,4698,273,1400000US17031280100,"Census Tract 2801,Cook County",17,031,280100,Illinois
501,618,565,53,1400000US17031280400,"Census Tract 2804,Cook County",17,031,280400,Illinois
502,479,374,105,1400000US17031280800,"Census Tract 2808,Cook County",17,031,280800,Illinois
503,420,367,53,1400000US17031280900,"Census Tract 2809,Cook County",17,031,280900,Illinois
504,4565,3939,626,1400000US17031281900,"Census Tract 2819,Cook County",17,031,281900,Illinois
505,1069,860,209,1400000US17031282700,"Census Tract 2827,Cook County",17,031,282700,Illinois
506,744,563,181,1400000US17031282800,"Census Tract 2828,Cook County",17,031,282800,Illinois
507,1545,1319,226,1400000US17031283100,"Census Tract 2831,Cook County",17,031,283100,Illinois
508,832,763,69,1400000US17031283200,"Census Tract 2832,Cook County",17,031,283200,Illinois
509,1708,1631,77,1400000US17031283800,"Census Tract 2838,Cook County",17,031,283800,Illinois
510,1781,1307,474,1400000US17031290900,"Census Tract 2909,Cook County",17,031,290900,Illinois
511,982,714,268,1400000US17031291200,"Census Tract 2912,Cook County",17,031,291200,Illinois
512,632,525,107,1400000US17031291600,"Census Tract 2916,Cook County",17,031,291600,Illinois
513,1250,961,289,1400000US17031292200,"Census Tract 2922,Cook County",17,031,292200,Illinois
514,969,689,280,1400000US17031292400,"Census Tract 2924,Cook County",17,031,292400,Illinois
515,1790,1545,245,1400000US17031292500,"Census Tract 2925,Cook County",17,031,292500,Illinois
516,1062,946,116,1400000US17031300500,"Census Tract 3005,Cook County",17,031,300500,Illinois
517,954,877,77,1400000US17031300600,"Census Tract 3006,Cook County",17,031,300600,Illinois
518,1799,1623,176,1400000US17031300700,"Census Tract 3007,Cook County",17,031,300700,Illinois
519,1322,1149,173,1400000US17031300800,"Census Tract 3008,Cook County",17,031,300800,Illinois
520,1727,1531,196,1400000US17031300900,"Census Tract 3009,Cook County",17,031,300900,Illinois
521,836,749,87,1400000US17031301100,"Census Tract 3011,Cook County",17,031,301100,Illinois
522,1604,1427,177,1400000US17031301200,"Census Tract 3012,Cook County",17,031,301200,Illinois
523,1537,1408,129,1400000US17031301600,"Census Tract 3016,Cook County",17,031,301600,Illinois
524,1405,1300,105,1400000US17031301701,"Census Tract 3017,01,Cook County",17,031,301701,Illinois
525,1321,1282,39,1400000US17031301702,"Census Tract 3017,02,Cook County",17,031,301702,Illinois
526,1247,1164,83,1400000US17031301801,"Census Tract 3018,01,Cook County",17,031,301801,Illinois
527,936,802,134,1400000US17031301802,"Census Tract 3018,02,Cook County",17,031,301802,Illinois
528,1353,1149,204,1400000US17031301803,"Census Tract 3018,03,Cook County",17,031,301803,Illinois
529,809,740,69,1400000US17031310200,"Census Tract 3102,Cook County",17,031,310200,Illinois
530,820,747,73,1400000US17031310300,"Census Tract 3103,Cook County",17,031,310300,Illinois
531,700,598,102,1400000US17031310400,"Census Tract 3104,Cook County",17,031,310400,Illinois
532,664,546,118,1400000US17031310500,"Census Tract 3105,Cook County",17,031,310500,Illinois
533,2578,2289,289,1400000US17031310600,"Census Tract 3106,Cook County",17,031,310600,Illinois
534,674,616,58,1400000US17031310700,"Census Tract 3107,Cook County",17,031,310700,Illinois
535,1822,1622,200,1400000US17031310800,"Census Tract 3108,Cook County",17,031,310800,Illinois
536,2024,1769,255,1400000US17031310900,"Census Tract 3109,Cook County",17,031,310900,Illinois
537,6282,4937,1345,1400000US17031320101,"Census Tract 3201,01,Cook County",17,031,320101,Illinois
538,2558,2441,117,1400000US17031320102,"Census Tract 3201,02,Cook County",17,031,320102,Illinois
539,1032,773,259,1400000US17031320400,"Census Tract 3204,Cook County",17,031,320400,Illinois
540,3849,3291,558,1400000US17031320600,"Census Tract 3206,Cook County",17,031,320600,Illinois
541,3035,2661,374,1400000US17031330101,"Census Tract 3301,01,Cook County",17,031,330101,Illinois
542,6202,5874,328,1400000US17031330102,"Census Tract 3301,02,Cook County",17,031,330102,Illinois
543,4685,4685,0,1400000US17031330103,"Census Tract 3301,03,Cook County",17,031,330103,Illinois
544,1971,1866,105,1400000US17031330200,"Census Tract 3302,Cook County",17,031,330200,Illinois
545,763,718,45,1400000US17031340300,"Census Tract 3403,Cook County",17,031,340300,Illinois
546,690,623,67,1400000US17031340400,"Census Tract 3404,Cook County",17,031,340400,Illinois
547,1040,945,95,1400000US17031340500,"Census Tract 3405,Cook County",17,031,340500,Illinois
548,485,464,21,1400000US17031340600,"Census Tract 3406,Cook County",17,031,340600,Illinois
549,1724,1501,223,1400000US17031350100,"Census Tract 3501,Cook County",17,031,350100,Illinois
550,761,709,52,1400000US17031350400,"Census Tract 3504,Cook County",17,031,350400,Illinois
551,2544,2322,222,1400000US17031351000,"Census Tract 3510,Cook County",17,031,351000,Illinois
552,1101,1101,0,1400000US17031351100,"Census Tract 3511,Cook County",17,031,351100,Illinois
553,937,860,77,1400000US17031351400,"Census Tract 3514,Cook County",17,031,351400,Illinois
554,413,378,35,1400000US17031351500,"Census Tract 3515,Cook County",17,031,351500,Illinois
555,803,756,47,1400000US17031360200,"Census Tract 3602,Cook County",17,031,360200,Illinois
556,1258,1137,121,1400000US17031380100,"Census Tract 3801,Cook County",17,031,380100,Illinois
557,1292,1235,57,1400000US17031380200,"Census Tract 3802,Cook County",17,031,380200,Illinois
558,2133,2007,126,1400000US17031380600,"Census Tract 3806,Cook County",17,031,380600,Illinois
559,1226,960,266,1400000US17031381200,"Census Tract 3812,Cook County",17,031,381200,Illinois
560,802,722,80,1400000US17031381400,"Census Tract 3814,Cook County",17,031,381400,Illinois
561,367,367,0,1400000US17031381500,"Census Tract 3815,Cook County",17,031,381500,Illinois
562,0,0,0,1400000US17031381700,"Census Tract 3817,Cook County",17,031,381700,Illinois
563,816,735,81,1400000US17031381800,"Census Tract 3818,Cook County",17,031,381800,Illinois
564,635,543,92,1400000US17031381900,"Census Tract 3819,Cook County",17,031,381900,Illinois
565,755,733,22,1400000US17031390100,"Census Tract 3901,Cook County",17,031,390100,Illinois
566,993,921,72,1400000US17031390200,"Census Tract 3902,Cook County",17,031,390200,Illinois
567,1868,1695,173,1400000US17031390300,"Census Tract 3903,Cook County",17,031,390300,Illinois
568,1703,1410,293,1400000US17031390400,"Census Tract 3904,Cook County",17,031,390400,Illinois
569,919,875,44,1400000US17031390500,"Census Tract 3905,Cook County",17,031,390500,Illinois
570,971,845,126,1400000US17031390600,"Census Tract 3906,Cook County",17,031,390600,Illinois
571,3918,3513,405,1400000US17031390700,"Census Tract 3907,Cook County",17,031,390700,Illinois
572,716,574,142,1400000US17031400300,"Census Tract 4003,Cook County",17,031,400300,Illinois
573,1035,889,146,1400000US17031400400,"Census Tract 4004,Cook County",17,031,400400,Illinois
574,1240,1067,173,1400000US17031400500,"Census Tract 4005,Cook County",17,031,400500,Illinois
575,1391,1173,218,1400000US17031400800,"Census Tract 4008,Cook County",17,031,400800,Illinois
576,1624,1394,230,1400000US17031410100,"Census Tract 4101,Cook County",17,031,410100,Illinois
577,780,770,10,1400000US17031410200,"Census Tract 4102,Cook County",17,031,410200,Illinois
578,1645,1542,103,1400000US17031410500,"Census Tract 4105,Cook County",17,031,410500,Illinois
579,1264,1108,156,1400000US17031410600,"Census Tract 4106,Cook County",17,031,410600,Illinois
580,1266,1122,144,1400000US17031410700,"Census Tract 4107,Cook County",17,031,410700,Illinois
581,1882,1730,152,1400000US17031410800,"Census Tract 4108,Cook County",17,031,410800,Illinois
582,1889,1744,145,1400000US17031410900,"Census Tract 4109,Cook County",17,031,410900,Illinois
583,2527,2235,292,1400000US17031411000,"Census Tract 4110,Cook County",17,031,411000,Illinois
584,1042,930,112,1400000US17031411100,"Census Tract 4111,Cook County",17,031,411100,Illinois
585,841,764,77,1400000US17031411200,"Census Tract 4112,Cook County",17,031,411200,Illinois
586,882,861,21,1400000US17031420100,"Census Tract 4201,Cook County",17,031,420100,Illinois
587,767,681,86,1400000US17031420200,"Census Tract 4202,Cook County",17,031,420200,Illinois
588,776,677,99,1400000US17031420300,"Census Tract 4203,Cook County",17,031,420300,Illinois
589,788,671,117,1400000US17031420400,"Census Tract 4204,Cook County",17,031,420400,Illinois
590,1265,925,340,1400000US17031420500,"Census Tract 4205,Cook County",17,031,420500,Illinois
591,1214,933,281,1400000US17031420600,"Census Tract 4206,Cook County",17,031,420600,Illinois
592,1848,1133,715,1400000US17031420700,"Census Tract 4207,Cook County",17,031,420700,Illinois
593,1214,937,277,1400000US17031420800,"Census Tract 4208,Cook County",17,031,420800,Illinois
594,995,672,323,1400000US17031421200,"Census Tract 4212,Cook County",17,031,421200,Illinois
595,2140,1712,428,1400000US17031430101,"Census Tract 4301,01,Cook County",17,031,430101,Illinois
596,2524,2417,107,1400000US17031430102,"Census Tract 4301,02,Cook County",17,031,430102,Illinois
597,2873,2723,150,1400000US17031430200,"Census Tract 4302,Cook County",17,031,430200,Illinois
598,1284,946,338,1400000US17031430300,"Census Tract 4303,Cook County",17,031,430300,Illinois
599,1618,1335,283,1400000US17031430400,"Census Tract 4304,Cook County",17,031,430400,Illinois
600,2323,1861,462,1400000US17031430500,"Census Tract 4305,Cook County",17,031,430500,Illinois
601,931,821,110,1400000US17031430600,"Census Tract 4306,Cook County",17,031,430600,Illinois
602,1447,1245,202,1400000US17031430700,"Census Tract 4307,Cook County",17,031,430700,Illinois
603,942,809,133,1400000US17031430800,"Census Tract 4308,Cook County",17,031,430800,Illinois
604,977,840,137,1400000US17031430900,"Census Tract 4309,Cook County",17,031,430900,Illinois
605,1418,1339,79,1400000US17031431200,"Census Tract 4312,Cook County",17,031,431200,Illinois
606,1953,1414,539,1400000US17031431301,"Census Tract 4313,01,Cook County",17,031,431301,Illinois
607,2247,1379,868,1400000US17031431302,"Census Tract 4313,02,Cook County",17,031,431302,Illinois
608,4142,3395,747,1400000US17031431400,"Census Tract 4314,Cook County",17,031,431400,Illinois
609,2821,2375,446,1400000US17031440101,"Census Tract 4401,01,Cook County",17,031,440101,Illinois
610,2182,1838,344,1400000US17031440102,"Census Tract 4401,02,Cook County",17,031,440102,Illinois
611,2944,2495,449,1400000US17031440201,"Census Tract 4402,01,Cook County",17,031,440201,Illinois
612,1756,1490,266,1400000US17031440202,"Census Tract 4402,02,Cook County",17,031,440202,Illinois
613,2389,2073,316,1400000US17031440300,"Census Tract 4403,Cook County",17,031,440300,Illinois
614,822,738,84,1400000US17031440600,"Census Tract 4406,Cook County",17,031,440600,Illinois
615,699,586,113,1400000US17031440700,"Census Tract 4407,Cook County",17,031,440700,Illinois
616,836,661,175,1400000US17031440800,"Census Tract 4408,Cook County",17,031,440800,Illinois
617,1286,976,310,1400000US17031440900,"Census Tract 4409,Cook County",17,031,440900,Illinois
618,1782,1515,267,1400000US17031450300,"Census Tract 4503,Cook County",17,031,450300,Illinois
619,1573,976,597,1400000US17031460100,"Census Tract 4601,Cook County",17,031,460100,Illinois
620,1272,957,315,1400000US17031460200,"Census Tract 4602,Cook County",17,031,460200,Illinois
621,1469,1152,317,1400000US17031460301,"Census Tract 4603,01,Cook County",17,031,460301,Illinois
622,1719,1167,552,1400000US17031460302,"Census Tract 4603,02,Cook County",17,031,460302,Illinois
623,1649,1303,346,1400000US17031460400,"Census Tract 4604,Cook County",17,031,460400,Illinois
624,3125,2800,325,1400000US17031460500,"Census Tract 4605,Cook County",17,031,460500,Illinois
625,1695,1341,354,1400000US17031460800,"Census Tract 4608,Cook County",17,031,460800,Illinois
626,935,732,203,1400000US17031461000,"Census Tract 4610,Cook County",17,031,461000,Illinois
627,1308,1042,266,1400000US17031470100,"Census Tract 4701,Cook County",17,031,470100,Illinois
628,959,945,14,1400000US17031480100,"Census Tract 4801,Cook County",17,031,480100,Illinois
629,716,579,137,1400000US17031480200,"Census Tract 4802,Cook County",17,031,480200,Illinois
630,634,565,69,1400000US17031480300,"Census Tract 4803,Cook County",17,031,480300,Illinois
631,2572,2301,271,1400000US17031480400,"Census Tract 4804,Cook County",17,031,480400,Illinois
632,1384,1193,191,1400000US17031480500,"Census Tract 4805,Cook County",17,031,480500,Illinois
633,1581,1422,159,1400000US17031490200,"Census Tract 4902,Cook County",17,031,490200,Illinois
634,869,757,112,1400000US17031490500,"Census Tract 4905,Cook County",17,031,490500,Illinois
635,630,551,79,1400000US17031490600,"Census Tract 4906,Cook County",17,031,490600,Illinois
636,1110,936,174,1400000US17031490700,"Census Tract 4907,Cook County",17,031,490700,Illinois
637,1564,1256,308,1400000US17031490800,"Census Tract 4908,Cook County",17,031,490800,Illinois
638,1645,1192,453,1400000US17031490901,"Census Tract 4909,01,Cook County",17,031,490901,Illinois
639,2144,1754,390,1400000US17031490902,"Census Tract 4909,02,Cook County",17,031,490902,Illinois
640,1700,1112,588,1400000US17031491000,"Census Tract 4910,Cook County",17,031,491000,Illinois
641,1564,1348,216,1400000US17031491100,"Census Tract 4911,Cook County",17,031,491100,Illinois
642,812,646,166,1400000US17031491200,"Census Tract 4912,Cook County",17,031,491200,Illinois
643,938,649,289,1400000US17031491300,"Census Tract 4913,Cook County",17,031,491300,Illinois
644,1593,1145,448,1400000US17031491400,"Census Tract 4914,Cook County",17,031,491400,Illinois
645,1743,1585,158,1400000US17031500100,"Census Tract 5001,Cook County",17,031,500100,Illinois
646,987,799,188,1400000US17031500200,"Census Tract 5002,Cook County",17,031,500200,Illinois
647,1041,905,136,1400000US17031500300,"Census Tract 5003,Cook County",17,031,500300,Illinois
648,1477,1261,216,1400000US17031510100,"Census Tract 5101,Cook County",17,031,510100,Illinois
649,1401,1267,134,1400000US17031510200,"Census Tract 5102,Cook County",17,031,510200,Illinois
650,2183,1866,317,1400000US17031510300,"Census Tract 5103,Cook County",17,031,510300,Illinois
651,611,510,101,1400000US17031520100,"Census Tract 5201,Cook County",17,031,520100,Illinois
652,1318,1140,178,1400000US17031520200,"Census Tract 5202,Cook County",17,031,520200,Illinois
653,2161,1923,238,1400000US17031520300,"Census Tract 5203,Cook County",17,031,520300,Illinois
654,1543,1462,81,1400000US17031520400,"Census Tract 5204,Cook County",17,031,520400,Illinois
655,1558,1520,38,1400000US17031520500,"Census Tract 5205,Cook County",17,031,520500,Illinois
656,830,778,52,1400000US17031520600,"Census Tract 5206,Cook County",17,031,520600,Illinois
657,1008,810,198,1400000US17031530100,"Census Tract 5301,Cook County",17,031,530100,Illinois
658,1993,1400,593,1400000US17031530200,"Census Tract 5302,Cook County",17,031,530200,Illinois
659,1726,1551,175,1400000US17031530300,"Census Tract 5303,Cook County",17,031,530300,Illinois
660,858,801,57,1400000US17031530400,"Census Tract 5304,Cook County",17,031,530400,Illinois
661,2396,1739,657,1400000US17031530501,"Census Tract 5305,01,Cook County",17,031,530501,Illinois
662,638,570,68,1400000US17031530502,"Census Tract 5305,02,Cook County",17,031,530502,Illinois
663,1731,1554,177,1400000US17031530503,"Census Tract 5305,03,Cook County",17,031,530503,Illinois
664,1285,900,385,1400000US17031530600,"Census Tract 5306,Cook County",17,031,530600,Illinois
665,1819,1661,158,1400000US17031540101,"Census Tract 5401,01,Cook County",17,031,540101,Illinois
666,1385,1244,141,1400000US17031540102,"Census Tract 5401,02,Cook County",17,031,540102,Illinois
667,3130,2717,413,1400000US17031550100,"Census Tract 5501,Cook County",17,031,550100,Illinois
668,1104,1076,28,1400000US17031550200,"Census Tract 5502,Cook County",17,031,550200,Illinois
669,388,361,27,1400000US17031560100,"Census Tract 5601,Cook County",17,031,560100,Illinois
670,599,562,37,1400000US17031560200,"Census Tract 5602,Cook County",17,031,560200,Illinois
671,1063,1048,15,1400000US17031560300,"Census Tract 5603,Cook County",17,031,560300,Illinois
672,480,480,0,1400000US17031560400,"Census Tract 5604,Cook County",17,031,560400,Illinois
673,1375,1312,63,1400000US17031560700,"Census Tract 5607,Cook County",17,031,560700,Illinois
674,2115,2007,108,1400000US17031560800,"Census Tract 5608,Cook County",17,031,560800,Illinois
675,1940,1860,80,1400000US17031560900,"Census Tract 5609,Cook County",17,031,560900,Illinois
676,2345,2285,60,1400000US17031561000,"Census Tract 5610,Cook County",17,031,561000,Illinois
677,2324,2185,139,1400000US17031561100,"Census Tract 5611,Cook County",17,031,561100,Illinois
678,467,446,21,1400000US17031570100,"Census Tract 5701,Cook County",17,031,570100,Illinois
679,833,824,9,1400000US17031570200,"Census Tract 5702,Cook County",17,031,570200,Illinois
680,1994,1755,239,1400000US17031570300,"Census Tract 5703,Cook County",17,031,570300,Illinois
681,621,584,37,1400000US17031570400,"Census Tract 5704,Cook County",17,031,570400,Illinois
682,839,756,83,1400000US17031570500,"Census Tract 5705,Cook County",17,031,570500,Illinois
683,1036,934,102,1400000US17031580100,"Census Tract 5801,Cook County",17,031,580100,Illinois
684,983,846,137,1400000US17031580200,"Census Tract 5802,Cook County",17,031,580200,Illinois
685,773,750,23,1400000US17031580300,"Census Tract 5803,Cook County",17,031,580300,Illinois
686,1559,1482,77,1400000US17031580400,"Census Tract 5804,Cook County",17,031,580400,Illinois
687,1660,1534,126,1400000US17031580501,"Census Tract 5805,01,Cook County",17,031,580501,Illinois
688,1507,1437,70,1400000US17031580502,"Census Tract 5805,02,Cook County",17,031,580502,Illinois
689,1735,1587,148,1400000US17031580600,"Census Tract 5806,Cook County",17,031,580600,Illinois
690,1812,1669,143,1400000US17031580700,"Census Tract 5807,Cook County",17,031,580700,Illinois
691,578,537,41,1400000US17031580800,"Census Tract 5808,Cook County",17,031,580800,Illinois
692,795,713,82,1400000US17031590500,"Census Tract 5905,Cook County",17,031,590500,Illinois
693,1447,1361,86,1400000US17031590600,"Census Tract 5906,Cook County",17,031,590600,Illinois
694,1133,1042,91,1400000US17031590700,"Census Tract 5907,Cook County",17,031,590700,Illinois
695,1713,1637,76,1400000US17031600400,"Census Tract 6004,Cook County",17,031,600400,Illinois
696,1248,1188,60,1400000US17031600600,"Census Tract 6006,Cook County",17,031,600600,Illinois
697,1354,1140,214,1400000US17031600700,"Census Tract 6007,Cook County",17,031,600700,Illinois
698,1501,1356,145,1400000US17031600900,"Census Tract 6009,Cook County",17,031,600900,Illinois
699,2285,2059,226,1400000US17031610300,"Census Tract 6103,Cook County",17,031,610300,Illinois
700,688,566,122,1400000US17031610400,"Census Tract 6104,Cook County",17,031,610400,Illinois
701,640,568,72,1400000US17031610800,"Census Tract 6108,Cook County",17,031,610800,Illinois
702,892,796,96,1400000US17031611200,"Census Tract 6112,Cook County",17,031,611200,Illinois
703,1148,1017,131,1400000US17031611300,"Census Tract 6113,Cook County",17,031,611300,Illinois
704,1144,927,217,1400000US17031611400,"Census Tract 6114,Cook County",17,031,611400,Illinois
705,1099,974,125,1400000US17031611500,"Census Tract 6115,Cook County",17,031,611500,Illinois
706,596,500,96,1400000US17031611600,"Census Tract 6116,Cook County",17,031,611600,Illinois
707,862,754,108,1400000US17031611700,"Census Tract 6117,Cook County",17,031,611700,Illinois
708,849,662,187,1400000US17031611800,"Census Tract 6118,Cook County",17,031,611800,Illinois
709,715,510,205,1400000US17031611900,"Census Tract 6119,Cook County",17,031,611900,Illinois
710,616,483,133,1400000US17031612000,"Census Tract 6120,Cook County",17,031,612000,Illinois
711,496,356,140,1400000US17031612100,"Census Tract 6121,Cook County",17,031,612100,Illinois
712,1362,1127,235,1400000US17031612200,"Census Tract 6122,Cook County",17,031,612200,Illinois
713,1221,1204,17,1400000US17031620100,"Census Tract 6201,Cook County",17,031,620100,Illinois
714,818,758,60,1400000US17031620200,"Census Tract 6202,Cook County",17,031,620200,Illinois
715,2343,2210,133,1400000US17031620300,"Census Tract 6203,Cook County",17,031,620300,Illinois
716,1396,1293,103,1400000US17031620400,"Census Tract 6204,Cook County",17,031,620400,Illinois
717,1508,1431,77,1400000US17031630300,"Census Tract 6303,Cook County",17,031,630300,Illinois
718,1909,1792,117,1400000US17031630400,"Census Tract 6304,Cook County",17,031,630400,Illinois
719,1788,1605,183,1400000US17031630500,"Census Tract 6305,Cook County",17,031,630500,Illinois
720,900,836,64,1400000US17031630600,"Census Tract 6306,Cook County",17,031,630600,Illinois
721,1872,1723,149,1400000US17031630800,"Census Tract 6308,Cook County",17,031,630800,Illinois
722,1524,1448,76,1400000US17031630900,"Census Tract 6309,Cook County",17,031,630900,Illinois
723,505,469,36,1400000US17031640100,"Census Tract 6401,Cook County",17,031,640100,Illinois
724,2503,2458,45,1400000US17031640300,"Census Tract 6403,Cook County",17,031,640300,Illinois
725,1275,1169,106,1400000US17031640400,"Census Tract 6404,Cook County",17,031,640400,Illinois
726,1614,1562,52,1400000US17031640500,"Census Tract 6405,Cook County",17,031,640500,Illinois
727,1881,1770,111,1400000US17031640600,"Census Tract 6406,Cook County",17,031,640600,Illinois
728,1074,1019,55,1400000US17031640700,"Census Tract 6407,Cook County",17,031,640700,Illinois
729,587,575,12,1400000US17031640800,"Census Tract 6408,Cook County",17,031,640800,Illinois
730,1460,1409,51,1400000US17031650100,"Census Tract 6501,Cook County",17,031,650100,Illinois
731,2223,2139,84,1400000US17031650200,"Census Tract 6502,Cook County",17,031,650200,Illinois
732,1689,1584,105,1400000US17031650301,"Census Tract 6503,01,Cook County",17,031,650301,Illinois
733,1251,1229,22,1400000US17031650302,"Census Tract 6503,02,Cook County",17,031,650302,Illinois
734,1657,1623,34,1400000US17031650400,"Census Tract 6504,Cook County",17,031,650400,Illinois
735,1744,1546,198,1400000US17031650500,"Census Tract 6505,Cook County",17,031,650500,Illinois
736,680,583,97,1400000US17031660301,"Census Tract 6603,01,Cook County",17,031,660301,Illinois
737,1626,1463,163,1400000US17031660302,"Census Tract 6603,02,Cook County",17,031,660302,Illinois
738,1633,1469,164,1400000US17031660400,"Census Tract 6604,Cook County",17,031,660400,Illinois
739,1518,1374,144,1400000US17031660500,"Census Tract 6605,Cook County",17,031,660500,Illinois
740,2290,1942,348,1400000US17031660600,"Census Tract 6606,Cook County",17,031,660600,Illinois
741,757,642,115,1400000US17031660700,"Census Tract 6607,Cook County",17,031,660700,Illinois
742,2468,2147,321,1400000US17031660800,"Census Tract 6608,Cook County",17,031,660800,Illinois
743,1942,1577,365,1400000US17031660900,"Census Tract 6609,Cook County",17,031,660900,Illinois
744,2354,2122,232,1400000US17031661000,"Census Tract 6610,Cook County",17,031,661000,Illinois
745,1949,1910,39,1400000US17031661100,"Census Tract 6611,Cook County",17,031,661100,Illinois
746,595,430,165,1400000US17031670100,"Census Tract 6701,Cook County",17,031,670100,Illinois
747,516,366,150,1400000US17031670200,"Census Tract 6702,Cook County",17,031,670200,Illinois
748,505,448,57,1400000US17031670300,"Census Tract 6703,Cook County",17,031,670300,Illinois
749,730,599,131,1400000US17031670400,"Census Tract 6704,Cook County",17,031,670400,Illinois
750,443,374,69,1400000US17031670500,"Census Tract 6705,Cook County",17,031,670500,Illinois
751,515,365,150,1400000US17031670600,"Census Tract 6706,Cook County",17,031,670600,Illinois
752,540,319,221,1400000US17031670700,"Census Tract 6707,Cook County",17,031,670700,Illinois
753,608,472,136,1400000US17031670800,"Census Tract 6708,Cook County",17,031,670800,Illinois
754,692,561,131,1400000US17031670900,"Census Tract 6709,Cook County",17,031,670900,Illinois
755,515,404,111,1400000US17031671100,"Census Tract 6711,Cook County",17,031,671100,Illinois
756,388,274,114,1400000US17031671200,"Census Tract 6712,Cook County",17,031,671200,Illinois
757,819,699,120,1400000US17031671300,"Census Tract 6713,Cook County",17,031,671300,Illinois
758,644,542,102,1400000US17031671400,"Census Tract 6714,Cook County",17,031,671400,Illinois
759,1144,903,241,1400000US17031671500,"Census Tract 6715,Cook County",17,031,671500,Illinois
760,989,670,319,1400000US17031671600,"Census Tract 6716,Cook County",17,031,671600,Illinois
761,477,394,83,1400000US17031671800,"Census Tract 6718,Cook County",17,031,671800,Illinois
762,419,339,80,1400000US17031671900,"Census Tract 6719,Cook County",17,031,671900,Illinois
763,1353,1018,335,1400000US17031672000,"Census Tract 6720,Cook County",17,031,672000,Illinois
764,600,501,99,1400000US17031680500,"Census Tract 6805,Cook County",17,031,680500,Illinois
765,703,434,269,1400000US17031680600,"Census Tract 6806,Cook County",17,031,680600,Illinois
766,2237,1994,243,1400000US17031680900,"Census Tract 6809,Cook County",17,031,680900,Illinois
767,1487,976,511,1400000US17031681000,"Census Tract 6810,Cook County",17,031,681000,Illinois
768,1382,765,617,1400000US17031681100,"Census Tract 6811,Cook County",17,031,681100,Illinois
769,1221,798,423,1400000US17031681200,"Census Tract 6812,Cook County",17,031,681200,Illinois
770,1343,860,483,1400000US17031681300,"Census Tract 6813,Cook County",17,031,681300,Illinois
771,1308,683,625,1400000US17031681400,"Census Tract 6814,Cook County",17,031,681400,Illinois
772,892,754,138,1400000US17031690300,"Census Tract 6903,Cook County",17,031,690300,Illinois
773,1972,1438,534,1400000US17031690400,"Census Tract 6904,Cook County",17,031,690400,Illinois
774,492,348,144,1400000US17031690500,"Census Tract 6905,Cook County",17,031,690500,Illinois
775,2332,1853,479,1400000US17031690900,"Census Tract 6909,Cook County",17,031,690900,Illinois
776,1409,1111,298,1400000US17031691000,"Census Tract 6910,Cook County",17,031,691000,Illinois
777,1433,891,542,1400000US17031691100,"Census Tract 6911,Cook County",17,031,691100,Illinois
778,1232,881,351,1400000US17031691200,"Census Tract 6912,Cook County",17,031,691200,Illinois
779,1165,1130,35,1400000US17031691300,"Census Tract 6913,Cook County",17,031,691300,Illinois
780,1703,1270,433,1400000US17031691400,"Census Tract 6914,Cook County",17,031,691400,Illinois
781,1148,884,264,1400000US17031691500,"Census Tract 6915,Cook County",17,031,691500,Illinois
782,1136,1046,90,1400000US17031700100,"Census Tract 7001,Cook County",17,031,700100,Illinois
783,1905,1882,23,1400000US17031700200,"Census Tract 7002,Cook County",17,031,700200,Illinois
784,1930,1898,32,1400000US17031700301,"Census Tract 7003,01,Cook County",17,031,700301,Illinois
785,1868,1812,56,1400000US17031700302,"Census Tract 7003,02,Cook County",17,031,700302,Illinois
786,1994,1926,68,1400000US17031700401,"Census Tract 7004,01,Cook County",17,031,700401,Illinois
787,1220,1189,31,1400000US17031700402,"Census Tract 7004,02,Cook County",17,031,700402,Illinois
788,2585,2512,73,1400000US17031700501,"Census Tract 7005,01,Cook County",17,031,700501,Illinois
789,1222,1177,45,1400000US17031700502,"Census Tract 7005,02,Cook County",17,031,700502,Illinois
790,684,541,143,1400000US17031710100,"Census Tract 7101,Cook County",17,031,710100,Illinois
791,2218,1733,485,1400000US17031710200,"Census Tract 7102,Cook County",17,031,710200,Illinois
792,645,527,118,1400000US17031710300,"Census Tract 7103,Cook County",17,031,710300,Illinois
793,2471,2168,303,1400000US17031710400,"Census Tract 7104,Cook County",17,031,710400,Illinois
794,1945,1503,442,1400000US17031710500,"Census Tract 7105,Cook County",17,031,710500,Illinois
795,1031,919,112,1400000US17031710600,"Census Tract 7106,Cook County",17,031,710600,Illinois
796,1622,1346,276,1400000US17031710700,"Census Tract 7107,Cook County",17,031,710700,Illinois
797,2276,1938,338,1400000US17031710800,"Census Tract 7108,Cook County",17,031,710800,Illinois
798,907,774,133,1400000US17031710900,"Census Tract 7109,Cook County",17,031,710900,Illinois
799,1461,1161,300,1400000US17031711000,"Census Tract 7110,Cook County",17,031,711000,Illinois
800,1089,935,154,1400000US17031711100,"Census Tract 7111,Cook County",17,031,711100,Illinois
801,2004,1766,238,1400000US17031711200,"Census Tract 7112,Cook County",17,031,711200,Illinois
802,720,677,43,1400000US17031711300,"Census Tract 7113,Cook County",17,031,711300,Illinois
803,976,850,126,1400000US17031711400,"Census Tract 7114,Cook County",17,031,711400,Illinois
804,977,871,106,1400000US17031711500,"Census Tract 7115,Cook County",17,031,711500,Illinois
805,1142,1092,50,1400000US17031720100,"Census Tract 7201,Cook County",17,031,720100,Illinois
806,1725,1614,111,1400000US17031720200,"Census Tract 7202,Cook County",17,031,720200,Illinois
807,1546,1501,45,1400000US17031720300,"Census Tract 7203,Cook County",17,031,720300,Illinois
808,737,684,53,1400000US17031720400,"Census Tract 7204,Cook County",17,031,720400,Illinois
809,825,728,97,1400000US17031720500,"Census Tract 7205,Cook County",17,031,720500,Illinois
810,637,631,6,1400000US17031720600,"Census Tract 7206,Cook County",17,031,720600,Illinois
811,1433,1172,261,1400000US17031720700,"Census Tract 7207,Cook County",17,031,720700,Illinois
812,983,929,54,1400000US17031730100,"Census Tract 7301,Cook County",17,031,730100,Illinois
813,2499,2077,422,1400000US17031730201,"Census Tract 7302,01,Cook County",17,031,730201,Illinois
814,1126,1007,119,1400000US17031730202,"Census Tract 7302,02,Cook County",17,031,730202,Illinois
815,461,386,75,1400000US17031730300,"Census Tract 7303,Cook County",17,031,730300,Illinois
816,1482,1432,50,1400000US17031730400,"Census Tract 7304,Cook County",17,031,730400,Illinois
817,1978,1769,209,1400000US17031730500,"Census Tract 7305,Cook County",17,031,730500,Illinois
818,1296,1094,202,1400000US17031730600,"Census Tract 7306,Cook County",17,031,730600,Illinois
819,905,788,117,1400000US17031730700,"Census Tract 7307,Cook County",17,031,730700,Illinois
820,1343,1199,144,1400000US17031740100,"Census Tract 7401,Cook County",17,031,740100,Illinois
821,2167,2087,80,1400000US17031740200,"Census Tract 7402,Cook County",17,031,740200,Illinois
822,1939,1939,0,1400000US17031740300,"Census Tract 7403,Cook County",17,031,740300,Illinois
823,2007,1883,124,1400000US17031740400,"Census Tract 7404,Cook County",17,031,740400,Illinois
824,1576,1495,81,1400000US17031750100,"Census Tract 7501,Cook County",17,031,750100,Illinois
825,1521,1389,132,1400000US17031750200,"Census Tract 7502,Cook County",17,031,750200,Illinois
826,1026,971,55,1400000US17031750300,"Census Tract 7503,Cook County",17,031,750300,Illinois
827,1306,1302,4,1400000US17031750400,"Census Tract 7504,Cook County",17,031,750400,Illinois
828,2163,1942,221,1400000US17031750500,"Census Tract 7505,Cook County",17,031,750500,Illinois
829,1393,1256,137,1400000US17031750600,"Census Tract 7506,Cook County",17,031,750600,Illinois
830,2519,2380,139,1400000US17031760801,"Census Tract 7608,01,Cook County",17,031,760801,Illinois
831,1207,1207,0,1400000US17031760802,"Census Tract 7608,02,Cook County",17,031,760802,Illinois
832,3170,2986,184,1400000US17031760803,"Census Tract 7608,03,Cook County",17,031,760803,Illinois
833,2814,2699,115,1400000US17031770201,"Census Tract 7702,01,Cook County",17,031,770201,Illinois
834,2081,1927,154,1400000US17031770202,"Census Tract 7702,02,Cook County",17,031,770202,Illinois
835,2870,2683,187,1400000US17031770300,"Census Tract 7703,Cook County",17,031,770300,Illinois
836,1665,1587,78,1400000US17031770400,"Census Tract 7704,Cook County",17,031,770400,Illinois
837,1177,1138,39,1400000US17031770500,"Census Tract 7705,Cook County",17,031,770500,Illinois
838,1175,1141,34,1400000US17031770601,"Census Tract 7706,01,Cook County",17,031,770601,Illinois
839,1644,1556,88,1400000US17031770602,"Census Tract 7706,02,Cook County",17,031,770602,Illinois
840,1146,1026,120,1400000US17031770700,"Census Tract 7707,Cook County",17,031,770700,Illinois
841,2206,2009,197,1400000US17031770800,"Census Tract 7708,Cook County",17,031,770800,Illinois
842,2115,1973,142,1400000US17031770901,"Census Tract 7709,01,Cook County",17,031,770901,Illinois
843,1561,1465,96,1400000US17031770902,"Census Tract 7709,02,Cook County",17,031,770902,Illinois
844,899,836,63,1400000US17031800100,"Census Tract 8001,Cook County",17,031,800100,Illinois
845,2527,2359,168,1400000US17031800200,"Census Tract 8002,Cook County",17,031,800200,Illinois
846,1337,1166,171,1400000US17031800300,"Census Tract 8003,Cook County",17,031,800300,Illinois
847,1432,1288,144,1400000US17031800400,"Census Tract 8004,Cook County",17,031,800400,Illinois
848,1950,1878,72,1400000US17031800500,"Census Tract 8005,Cook County",17,031,800500,Illinois
849,738,700,38,1400000US17031800600,"Census Tract 8006,Cook County",17,031,800600,Illinois
850,1793,1719,74,1400000US17031800700,"Census Tract 8007,Cook County",17,031,800700,Illinois
851,1113,973,140,1400000US17031800800,"Census Tract 8008,Cook County",17,031,800800,Illinois
852,1794,1645,149,1400000US17031800900,"Census Tract 8009,Cook County",17,031,800900,Illinois
853,2251,2158,93,1400000US17031801000,"Census Tract 8010,Cook County",17,031,801000,Illinois
854,1660,1600,60,1400000US17031801100,"Census Tract 8011,Cook County",17,031,801100,Illinois
855,1552,1444,108,1400000US17031801200,"Census Tract 8012,Cook County",17,031,801200,Illinois
856,1801,1738,63,1400000US17031801300,"Census Tract 8013,Cook County",17,031,801300,Illinois
857,1191,1148,43,1400000US17031801400,"Census Tract 8014,Cook County",17,031,801400,Illinois
858,2967,2611,356,1400000US17031801500,"Census Tract 8015,Cook County",17,031,801500,Illinois
859,2050,1894,156,1400000US17031801601,"Census Tract 8016,01,Cook County",17,031,801601,Illinois
860,1745,1527,218,1400000US17031801603,"Census Tract 8016,03,Cook County",17,031,801603,Illinois
861,2377,2118,259,1400000US17031801605,"Census Tract 8016,05,Cook County",17,031,801605,Illinois
862,3110,2824,286,1400000US17031801606,"Census Tract 8016,06,Cook County",17,031,801606,Illinois
863,2274,2025,249,1400000US17031801607,"Census Tract 8016,07,Cook County",17,031,801607,Illinois
864,3161,2797,364,1400000US17031801608,"Census Tract 8016,08,Cook County",17,031,801608,Illinois
865,1282,1194,88,1400000US17031801701,"Census Tract 8017,01,Cook County",17,031,801701,Illinois
866,1924,1760,164,1400000US17031801702,"Census Tract 8017,02,Cook County",17,031,801702,Illinois
867,2589,2425,164,1400000US17031801800,"Census Tract 8018,Cook County",17,031,801800,Illinois
868,2156,1948,208,1400000US17031801901,"Census Tract 8019,01,Cook County",17,031,801901,Illinois
869,1317,1241,76,1400000US17031801902,"Census Tract 8019,02,Cook County",17,031,801902,Illinois
870,1690,1681,9,1400000US17031802002,"Census Tract 8020,02,Cook County",17,031,802002,Illinois
871,867,801,66,1400000US17031802003,"Census Tract 8020,03,Cook County",17,031,802003,Illinois
872,2510,2383,127,1400000US17031802004,"Census Tract 8020,04,Cook County",17,031,802004,Illinois
873,1313,1182,131,1400000US17031802100,"Census Tract 8021,Cook County",17,031,802100,Illinois
874,2056,1962,94,1400000US17031802200,"Census Tract 8022,Cook County",17,031,802200,Illinois
875,2757,2586,171,1400000US17031802300,"Census Tract 8023,Cook County",17,031,802300,Illinois
876,2651,2424,227,1400000US17031802402,"Census Tract 8024,02,Cook County",17,031,802402,Illinois
877,854,848,6,1400000US17031802403,"Census Tract 8024,03,Cook County",17,031,802403,Illinois
878,3293,3122,171,1400000US17031802404,"Census Tract 8024,04,Cook County",17,031,802404,Illinois
879,2628,2628,0,1400000US17031802503,"Census Tract 8025,03,Cook County",17,031,802503,Illinois
880,2054,2054,0,1400000US17031802504,"Census Tract 8025,04,Cook County",17,031,802504,Illinois
881,2681,2496,185,1400000US17031802505,"Census Tract 8025,05,Cook County",17,031,802505,Illinois
882,806,785,21,1400000US17031802506,"Census Tract 8025,06,Cook County",17,031,802506,Illinois
883,3185,3086,99,1400000US17031802605,"Census Tract 8026,05,Cook County",17,031,802605,Illinois
884,452,432,20,1400000US17031802607,"Census Tract 8026,07,Cook County",17,031,802607,Illinois
885,2970,2945,25,1400000US17031802608,"Census Tract 8026,08,Cook County",17,031,802608,Illinois
886,2740,2740,0,1400000US17031802609,"Census Tract 8026,09,Cook County",17,031,802609,Illinois
887,795,783,12,1400000US17031802610,"Census Tract 8026,10,Cook County",17,031,802610,Illinois
888,2240,2240,0,1400000US17031802701,"Census Tract 8027,01,Cook County",17,031,802701,Illinois
889,1798,1715,83,1400000US17031802702,"Census Tract 8027,02,Cook County",17,031,802702,Illinois
890,1924,1873,51,1400000US17031802801,"Census Tract 8028,01,Cook County",17,031,802801,Illinois
891,2536,2356,180,1400000US17031802802,"Census Tract 8028,02,Cook County",17,031,802802,Illinois
892,2118,2086,32,1400000US17031802900,"Census Tract 8029,Cook County",17,031,802900,Illinois
893,1243,1214,29,1400000US17031803005,"Census Tract 8030,05,Cook County",17,031,803005,Illinois
894,2208,2164,44,1400000US17031803007,"Census Tract 8030,07,Cook County",17,031,803007,Illinois
895,1717,1717,0,1400000US17031803008,"Census Tract 8030,08,Cook County",17,031,803008,Illinois
896,1741,1741,0,1400000US17031803010,"Census Tract 8030,10,Cook County",17,031,803010,Illinois
897,1082,981,101,1400000US17031803012,"Census Tract 8030,12,Cook County",17,031,803012,Illinois
898,2434,2344,90,1400000US17031803013,"Census Tract 8030,13,Cook County",17,031,803013,Illinois
899,1486,1417,69,1400000US17031803014,"Census Tract 8030,14,Cook County",17,031,803014,Illinois
900,2073,1962,111,1400000US17031803015,"Census Tract 8030,15,Cook County",17,031,803015,Illinois
901,1025,931,94,1400000US17031803016,"Census Tract 8030,16,Cook County",17,031,803016,Illinois
902,2613,2560,53,1400000US17031803017,"Census Tract 8030,17,Cook County",17,031,803017,Illinois
903,1179,1179,0,1400000US17031803100,"Census Tract 8031,Cook County",17,031,803100,Illinois
904,2403,2172,231,1400000US17031803200,"Census Tract 8032,Cook County",17,031,803200,Illinois
905,3441,2993,448,1400000US17031803300,"Census Tract 8033,Cook County",17,031,803300,Illinois
906,2324,2289,35,1400000US17031803400,"Census Tract 8034,Cook County",17,031,803400,Illinois
907,2267,2222,45,1400000US17031803500,"Census Tract 8035,Cook County",17,031,803500,Illinois
908,2463,2228,235,1400000US17031803603,"Census Tract 8036,03,Cook County",17,031,803603,Illinois
909,1807,1783,24,1400000US17031803604,"Census Tract 8036,04,Cook County",17,031,803604,Illinois
910,2641,2560,81,1400000US17031803605,"Census Tract 8036,05,Cook County",17,031,803605,Illinois
911,1701,1654,47,1400000US17031803607,"Census Tract 8036,07,Cook County",17,031,803607,Illinois
912,3459,3230,229,1400000US17031803608,"Census Tract 8036,08,Cook County",17,031,803608,Illinois
913,2284,2129,155,1400000US17031803611,"Census Tract 8036,11,Cook County",17,031,803611,Illinois
914,1490,1404,86,1400000US17031803612,"Census Tract 8036,12,Cook County",17,031,803612,Illinois
915,1151,1059,92,1400000US17031803613,"Census Tract 8036,13,Cook County",17,031,803613,Illinois
916,1603,1603,0,1400000US17031803614,"Census Tract 8036,14,Cook County",17,031,803614,Illinois
917,1125,1027,98,1400000US17031803615,"Census Tract 8036,15,Cook County",17,031,803615,Illinois
918,2319,2013,306,1400000US17031803616,"Census Tract 8036,16,Cook County",17,031,803616,Illinois
919,1498,1318,180,1400000US17031803701,"Census Tract 8037,01,Cook County",17,031,803701,Illinois
920,2701,2489,212,1400000US17031803702,"Census Tract 8037,02,Cook County",17,031,803702,Illinois
921,1818,1740,78,1400000US17031803800,"Census Tract 8038,Cook County",17,031,803800,Illinois
922,2082,1987,95,1400000US17031803901,"Census Tract 8039,01,Cook County",17,031,803901,Illinois
923,1350,1275,75,1400000US17031803902,"Census Tract 8039,02,Cook County",17,031,803902,Illinois
924,2033,1999,34,1400000US17031804000,"Census Tract 8040,Cook County",17,031,804000,Illinois
925,2573,2481,92,1400000US17031804102,"Census Tract 8041,02,Cook County",17,031,804102,Illinois
926,1878,1814,64,1400000US17031804104,"Census Tract 8041,04,Cook County",17,031,804104,Illinois
927,1532,1449,83,1400000US17031804105,"Census Tract 8041,05,Cook County",17,031,804105,Illinois
928,2781,2658,123,1400000US17031804106,"Census Tract 8041,06,Cook County",17,031,804106,Illinois
929,2507,2275,232,1400000US17031804108,"Census Tract 8041,08,Cook County",17,031,804108,Illinois
930,1235,1177,58,1400000US17031804109,"Census Tract 8041,09,Cook County",17,031,804109,Illinois
931,2946,2830,116,1400000US17031804202,"Census Tract 8042,02,Cook County",17,031,804202,Illinois
932,1017,1017,0,1400000US17031804203,"Census Tract 8042,03,Cook County",17,031,804203,Illinois
933,1981,1912,69,1400000US17031804204,"Census Tract 8042,04,Cook County",17,031,804204,Illinois
934,2713,2654,59,1400000US17031804305,"Census Tract 8043,05,Cook County",17,031,804305,Illinois
935,1853,1806,47,1400000US17031804306,"Census Tract 8043,06,Cook County",17,031,804306,Illinois
936,2198,2198,0,1400000US17031804308,"Census Tract 8043,08,Cook County",17,031,804308,Illinois
937,958,958,0,1400000US17031804309,"Census Tract 8043,09,Cook County",17,031,804309,Illinois
938,644,644,0,1400000US17031804312,"Census Tract 8043,12,Cook County",17,031,804312,Illinois
939,2269,2187,82,1400000US17031804313,"Census Tract 8043,13,Cook County",17,031,804313,Illinois
940,655,631,24,1400000US17031804314,"Census Tract 8043,14,Cook County",17,031,804314,Illinois
941,854,854,0,1400000US17031804315,"Census Tract 8043,15,Cook County",17,031,804315,Illinois
942,1662,1618,44,1400000US17031804316,"Census Tract 8043,16,Cook County",17,031,804316,Illinois
943,2741,2532,209,1400000US17031804403,"Census Tract 8044,03,Cook County",17,031,804403,Illinois
944,1657,1619,38,1400000US17031804404,"Census Tract 8044,04,Cook County",17,031,804404,Illinois
945,1038,1018,20,1400000US17031804405,"Census Tract 8044,05,Cook County",17,031,804405,Illinois
946,1976,1844,132,1400000US17031804406,"Census Tract 8044,06,Cook County",17,031,804406,Illinois
947,1572,1463,109,1400000US17031804505,"Census Tract 8045,05,Cook County",17,031,804505,Illinois
948,1994,1919,75,1400000US17031804506,"Census Tract 8045,06,Cook County",17,031,804506,Illinois
949,874,808,66,1400000US17031804508,"Census Tract 8045,08,Cook County",17,031,804508,Illinois
950,1640,1616,24,1400000US17031804509,"Census Tract 8045,09,Cook County",17,031,804509,Illinois
951,1447,1371,76,1400000US17031804510,"Census Tract 8045,10,Cook County",17,031,804510,Illinois
952,750,714,36,1400000US17031804511,"Census Tract 8045,11,Cook County",17,031,804511,Illinois
953,1451,1325,126,1400000US17031804512,"Census Tract 8045,12,Cook County",17,031,804512,Illinois
954,1496,1419,77,1400000US17031804513,"Census Tract 8045,13,Cook County",17,031,804513,Illinois
955,1697,1653,44,1400000US17031804514,"Census Tract 8045,14,Cook County",17,031,804514,Illinois
956,2935,2863,72,1400000US17031804603,"Census Tract 8046,03,Cook County",17,031,804603,Illinois
957,2428,2428,0,1400000US17031804606,"Census Tract 8046,06,Cook County",17,031,804606,Illinois
958,2743,2614,129,1400000US17031804607,"Census Tract 8046,07,Cook County",17,031,804607,Illinois
959,1609,1554,55,1400000US17031804608,"Census Tract 8046,08,Cook County",17,031,804608,Illinois
960,2577,2463,114,1400000US17031804609,"Census Tract 8046,09,Cook County",17,031,804609,Illinois
961,1295,1227,68,1400000US17031804610,"Census Tract 8046,10,Cook County",17,031,804610,Illinois
962,2022,1878,144,1400000US17031804611,"Census Tract 8046,11,Cook County",17,031,804611,Illinois
963,2559,2472,87,1400000US17031804701,"Census Tract 8047,01,Cook County",17,031,804701,Illinois
964,1742,1694,48,1400000US17031804705,"Census Tract 8047,05,Cook County",17,031,804705,Illinois
965,720,720,0,1400000US17031804706,"Census Tract 8047,06,Cook County",17,031,804706,Illinois
966,3303,2906,397,1400000US17031804709,"Census Tract 8047,09,Cook County",17,031,804709,Illinois
967,1588,1506,82,1400000US17031804710,"Census Tract 8047,10,Cook County",17,031,804710,Illinois
968,2970,2877,93,1400000US17031804711,"Census Tract 8047,11,Cook County",17,031,804711,Illinois
969,2031,1935,96,1400000US17031804712,"Census Tract 8047,12,Cook County",17,031,804712,Illinois
970,2387,2216,171,1400000US17031804713,"Census Tract 8047,13,Cook County",17,031,804713,Illinois
971,1380,1281,99,1400000US17031804714,"Census Tract 8047,14,Cook County",17,031,804714,Illinois
972,1232,1232,0,1400000US17031804715,"Census Tract 8047,15,Cook County",17,031,804715,Illinois
973,1622,1478,144,1400000US17031804716,"Census Tract 8047,16,Cook County",17,031,804716,Illinois
974,2006,1940,66,1400000US17031804803,"Census Tract 8048,03,Cook County",17,031,804803,Illinois
975,2677,2563,114,1400000US17031804804,"Census Tract 8048,04,Cook County",17,031,804804,Illinois
976,2585,2451,134,1400000US17031804805,"Census Tract 8048,05,Cook County",17,031,804805,Illinois
977,1010,999,11,1400000US17031804806,"Census Tract 8048,06,Cook County",17,031,804806,Illinois
978,1986,1905,81,1400000US17031804807,"Census Tract 8048,07,Cook County",17,031,804807,Illinois
979,962,929,33,1400000US17031804808,"Census Tract 8048,08,Cook County",17,031,804808,Illinois
980,1651,1651,0,1400000US17031804809,"Census Tract 8048,09,Cook County",17,031,804809,Illinois
981,2970,2865,105,1400000US17031804810,"Census Tract 8048,10,Cook County",17,031,804810,Illinois
982,2530,2375,155,1400000US17031804901,"Census Tract 8049,01,Cook County",17,031,804901,Illinois
983,2332,2179,153,1400000US17031804902,"Census Tract 8049,02,Cook County",17,031,804902,Illinois
984,1981,1913,68,1400000US17031805001,"Census Tract 8050,01,Cook County",17,031,805001,Illinois
985,3208,3005,203,1400000US17031805002,"Census Tract 8050,02,Cook County",17,031,805002,Illinois
986,3009,2807,202,1400000US17031805105,"Census Tract 8051,05,Cook County",17,031,805105,Illinois
987,1327,1271,56,1400000US17031805106,"Census Tract 8051,06,Cook County",17,031,805106,Illinois
988,3321,2930,391,1400000US17031805107,"Census Tract 8051,07,Cook County",17,031,805107,Illinois
989,2891,2582,309,1400000US17031805108,"Census Tract 8051,08,Cook County",17,031,805108,Illinois
990,1845,1762,83,1400000US17031805109,"Census Tract 8051,09,Cook County",17,031,805109,Illinois
991,2101,1933,168,1400000US17031805110,"Census Tract 8051,10,Cook County",17,031,805110,Illinois
992,3059,2847,212,1400000US17031805111,"Census Tract 8051,11,Cook County",17,031,805111,Illinois
993,1347,1117,230,1400000US17031805112,"Census Tract 8051,12,Cook County",17,031,805112,Illinois
994,1310,1276,34,1400000US17031805201,"Census Tract 8052,01,Cook County",17,031,805201,Illinois
995,1707,1622,85,1400000US17031805202,"Census Tract 8052,02,Cook County",17,031,805202,Illinois
996,1167,1083,84,1400000US17031805301,"Census Tract 8053,01,Cook County",17,031,805301,Illinois
997,1484,1429,55,1400000US17031805302,"Census Tract 8053,02,Cook County",17,031,805302,Illinois
998,1646,1627,19,1400000US17031805401,"Census Tract 8054,01,Cook County",17,031,805401,Illinois
999,1927,1771,156,1400000US17031805402,"Census Tract 8054,02,Cook County",17,031,805402,Illinois
1000,1752,1523,229,1400000US17031805501,"Census Tract 8055,01,Cook County",17,031,805501,Illinois
1001,1902,1816,86,1400000US17031805502,"Census Tract 8055,02,Cook County",17,031,805502,Illinois
1002,1682,1655,27,1400000US17031805600,"Census Tract 8056,Cook County",17,031,805600,Illinois
1003,2186,2045,141,1400000US17031805701,"Census Tract 8057,01,Cook County",17,031,805701,Illinois
1004,754,716,38,1400000US17031805702,"Census Tract 8057,02,Cook County",17,031,805702,Illinois
1005,1101,1020,81,1400000US17031805801,"Census Tract 8058,01,Cook County",17,031,805801,Illinois
1006,2054,1946,108,1400000US17031805802,"Census Tract 8058,02,Cook County",17,031,805802,Illinois
1007,2234,2045,189,1400000US17031805901,"Census Tract 8059,01,Cook County",17,031,805901,Illinois
1008,2404,2182,222,1400000US17031805902,"Census Tract 8059,02,Cook County",17,031,805902,Illinois
1009,2820,2598,222,1400000US17031806001,"Census Tract 8060,01,Cook County",17,031,806001,Illinois
1010,2780,2522,258,1400000US17031806002,"Census Tract 8060,02,Cook County",17,031,806002,Illinois
1011,3330,3283,47,1400000US17031806004,"Census Tract 8060,04,Cook County",17,031,806004,Illinois
1012,1330,1091,239,1400000US17031806005,"Census Tract 8060,05,Cook County",17,031,806005,Illinois
1013,1839,1763,76,1400000US17031806006,"Census Tract 8060,06,Cook County",17,031,806006,Illinois
1014,1628,1455,173,1400000US17031806102,"Census Tract 8061,02,Cook County",17,031,806102,Illinois
1015,2025,1970,55,1400000US17031806103,"Census Tract 8061,03,Cook County",17,031,806103,Illinois
1016,2153,1925,228,1400000US17031806104,"Census Tract 8061,04,Cook County",17,031,806104,Illinois
1017,2406,2238,168,1400000US17031806201,"Census Tract 8062,01,Cook County",17,031,806201,Illinois
1018,2628,2527,101,1400000US17031806202,"Census Tract 8062,02,Cook County",17,031,806202,Illinois
1019,1844,1734,110,1400000US17031806300,"Census Tract 8063,Cook County",17,031,806300,Illinois
1020,862,836,26,1400000US17031806400,"Census Tract 8064,Cook County",17,031,806400,Illinois
1021,799,743,56,1400000US17031806501,"Census Tract 8065,01,Cook County",17,031,806501,Illinois
1022,1466,1466,0,1400000US17031806502,"Census Tract 8065,02,Cook County",17,031,806502,Illinois
1023,1288,1206,82,1400000US17031806600,"Census Tract 8066,Cook County",17,031,806600,Illinois
1024,1765,1726,39,1400000US17031806700,"Census Tract 8067,Cook County",17,031,806700,Illinois
1025,1702,1655,47,1400000US17031806801,"Census Tract 8068,01,Cook County",17,031,806801,Illinois
1026,1193,1091,102,1400000US17031806802,"Census Tract 8068,02,Cook County",17,031,806802,Illinois
1027,2375,2233,142,1400000US17031806900,"Census Tract 8069,Cook County",17,031,806900,Illinois
1028,2174,2010,164,1400000US17031807000,"Census Tract 8070,Cook County",17,031,807000,Illinois
1029,1334,1163,171,1400000US17031807100,"Census Tract 8071,Cook County",17,031,807100,Illinois
1030,2044,1933,111,1400000US17031807200,"Census Tract 8072,Cook County",17,031,807200,Illinois
1031,3130,3012,118,1400000US17031807300,"Census Tract 8073,Cook County",17,031,807300,Illinois
1032,2446,2374,72,1400000US17031807400,"Census Tract 8074,Cook County",17,031,807400,Illinois
1033,1124,1124,0,1400000US17031807500,"Census Tract 8075,Cook County",17,031,807500,Illinois
1034,2345,2154,191,1400000US17031807600,"Census Tract 8076,Cook County",17,031,807600,Illinois
1035,2454,2300,154,1400000US17031807700,"Census Tract 8077,Cook County",17,031,807700,Illinois
1036,900,859,41,1400000US17031807800,"Census Tract 8078,Cook County",17,031,807800,Illinois
1037,1583,1446,137,1400000US17031807900,"Census Tract 8079,Cook County",17,031,807900,Illinois
1038,1540,1467,73,1400000US17031808001,"Census Tract 8080,01,Cook County",17,031,808001,Illinois
1039,2124,1853,271,1400000US17031808002,"Census Tract 8080,02,Cook County",17,031,808002,Illinois
1040,1894,1807,87,1400000US17031808100,"Census Tract 8081,Cook County",17,031,808100,Illinois
1041,2007,1932,75,1400000US17031808200,"Census Tract 8082,Cook County",17,031,808200,Illinois
1042,2983,2742,241,1400000US17031808301,"Census Tract 8083,01,Cook County",17,031,808301,Illinois
1043,1970,1878,92,1400000US17031808302,"Census Tract 8083,02,Cook County",17,031,808302,Illinois
1044,1691,1590,101,1400000US17031808400,"Census Tract 8084,Cook County",17,031,808400,Illinois
1045,1521,1479,42,1400000US17031808500,"Census Tract 8085,Cook County",17,031,808500,Illinois
1046,918,822,96,1400000US17031808600,"Census Tract 8086,Cook County",17,031,808600,Illinois
1047,516,436,80,1400000US17031808702,"Census Tract 8087,02,Cook County",17,031,808702,Illinois
1048,1768,1651,117,1400000US17031808800,"Census Tract 8088,Cook County",17,031,808800,Illinois
1049,1853,1731,122,1400000US17031808900,"Census Tract 8089,Cook County",17,031,808900,Illinois
1050,1708,1520,188,1400000US17031809000,"Census Tract 8090,Cook County",17,031,809000,Illinois
1051,1717,1460,257,1400000US17031809100,"Census Tract 8091,Cook County",17,031,809100,Illinois
1052,1840,1562,278,1400000US17031809200,"Census Tract 8092,Cook County",17,031,809200,Illinois
1053,2060,1766,294,1400000US17031809300,"Census Tract 8093,Cook County",17,031,809300,Illinois
1054,1646,1436,210,1400000US17031809401,"Census Tract 8094,01,Cook County",17,031,809401,Illinois
1055,1671,1358,313,1400000US17031809402,"Census Tract 8094,02,Cook County",17,031,809402,Illinois
1056,2192,1999,193,1400000US17031809500,"Census Tract 8095,Cook County",17,031,809500,Illinois
1057,1353,1321,32,1400000US17031809600,"Census Tract 8096,Cook County",17,031,809600,Illinois
1058,1390,1287,103,1400000US17031809700,"Census Tract 8097,Cook County",17,031,809700,Illinois
1059,1131,994,137,1400000US17031809800,"Census Tract 8098,Cook County",17,031,809800,Illinois
1060,1447,1287,160,1400000US17031809900,"Census Tract 8099,Cook County",17,031,809900,Illinois
1061,3095,2845,250,1400000US17031810000,"Census Tract 8100,Cook County",17,031,810000,Illinois
1062,2114,1996,118,1400000US17031810100,"Census Tract 8101,Cook County",17,031,810100,Illinois
1063,2925,2753,172,1400000US17031810200,"Census Tract 8102,Cook County",17,031,810200,Illinois
1064,1603,1573,30,1400000US17031810301,"Census Tract 8103,01,Cook County",17,031,810301,Illinois
1065,1373,1281,92,1400000US17031810302,"Census Tract 8103,02,Cook County",17,031,810302,Illinois
1066,2259,2162,97,1400000US17031810400,"Census Tract 8104,Cook County",17,031,810400,Illinois
1067,2105,2058,47,1400000US17031810501,"Census Tract 8105,01,Cook County",17,031,810501,Illinois
1068,2353,2267,86,1400000US17031810502,"Census Tract 8105,02,Cook County",17,031,810502,Illinois
1069,1883,1804,79,1400000US17031810600,"Census Tract 8106,Cook County",17,031,810600,Illinois
1070,1984,1830,154,1400000US17031810701,"Census Tract 8107,01,Cook County",17,031,810701,Illinois
1071,1660,1439,221,1400000US17031810702,"Census Tract 8107,02,Cook County",17,031,810702,Illinois
1072,1756,1662,94,1400000US17031810800,"Census Tract 8108,Cook County",17,031,810800,Illinois
1073,2803,2567,236,1400000US17031810900,"Census Tract 8109,Cook County",17,031,810900,Illinois
1074,1742,1734,8,1400000US17031811000,"Census Tract 8110,Cook County",17,031,811000,Illinois
1075,2714,2465,249,1400000US17031811100,"Census Tract 8111,Cook County",17,031,811100,Illinois
1076,2018,1836,182,1400000US17031811200,"Census Tract 8112,Cook County",17,031,811200,Illinois
1077,1489,1395,94,1400000US17031811301,"Census Tract 8113,01,Cook County",17,031,811301,Illinois
1078,1331,1267,64,1400000US17031811302,"Census Tract 8113,02,Cook County",17,031,811302,Illinois
1079,1666,1494,172,1400000US17031811401,"Census Tract 8114,01,Cook County",17,031,811401,Illinois
1080,1478,1364,114,1400000US17031811402,"Census Tract 8114,02,Cook County",17,031,811402,Illinois
1081,2149,2044,105,1400000US17031811500,"Census Tract 8115,Cook County",17,031,811500,Illinois
1082,2374,2290,84,1400000US17031811600,"Census Tract 8116,Cook County",17,031,811600,Illinois
1083,1134,1094,40,1400000US17031811701,"Census Tract 8117,01,Cook County",17,031,811701,Illinois
1084,2085,1960,125,1400000US17031811702,"Census Tract 8117,02,Cook County",17,031,811702,Illinois
1085,1896,1791,105,1400000US17031811800,"Census Tract 8118,Cook County",17,031,811800,Illinois
1086,2100,1917,183,1400000US17031811900,"Census Tract 8119,Cook County",17,031,811900,Illinois
1087,2599,2511,88,1400000US17031812000,"Census Tract 8120,Cook County",17,031,812000,Illinois
1088,1664,1582,82,1400000US17031812100,"Census Tract 8121,Cook County",17,031,812100,Illinois
1089,1348,1315,33,1400000US17031812200,"Census Tract 8122,Cook County",17,031,812200,Illinois
1090,3263,2968,295,1400000US17031812301,"Census Tract 8123,01,Cook County",17,031,812301,Illinois
1091,1105,1081,24,1400000US17031812302,"Census Tract 8123,02,Cook County",17,031,812302,Illinois
1092,1206,1115,91,1400000US17031812400,"Census Tract 8124,Cook County",17,031,812400,Illinois
1093,1721,1594,127,1400000US17031812500,"Census Tract 8125,Cook County",17,031,812500,Illinois
1094,1919,1826,93,1400000US17031812600,"Census Tract 8126,Cook County",17,031,812600,Illinois
1095,1759,1604,155,1400000US17031812700,"Census Tract 8127,Cook County",17,031,812700,Illinois
1096,1918,1829,89,1400000US17031812801,"Census Tract 8128,01,Cook County",17,031,812801,Illinois
1097,1350,1234,116,1400000US17031812802,"Census Tract 8128,02,Cook County",17,031,812802,Illinois
1098,1890,1734,156,1400000US17031812900,"Census Tract 8129,Cook County",17,031,812900,Illinois
1099,1524,1498,26,1400000US17031813000,"Census Tract 8130,Cook County",17,031,813000,Illinois
1100,1855,1801,54,1400000US17031813100,"Census Tract 8131,Cook County",17,031,813100,Illinois
1101,1678,1612,66,1400000US17031813200,"Census Tract 8132,Cook County",17,031,813200,Illinois
1102,1163,982,181,1400000US17031813301,"Census Tract 8133,01,Cook County",17,031,813301,Illinois
1103,1088,955,133,1400000US17031813302,"Census Tract 8133,02,Cook County",17,031,813302,Illinois
1104,2041,1874,167,1400000US17031813400,"Census Tract 8134,Cook County",17,031,813400,Illinois
1105,2133,1974,159,1400000US17031813500,"Census Tract 8135,Cook County",17,031,813500,Illinois
1106,1728,1630,98,1400000US17031813600,"Census Tract 8136,Cook County",17,031,813600,Illinois
1107,1111,986,125,1400000US17031813701,"Census Tract 8137,01,Cook County",17,031,813701,Illinois
1108,1284,1244,40,1400000US17031813702,"Census Tract 8137,02,Cook County",17,031,813702,Illinois
1109,1024,981,43,1400000US17031813801,"Census Tract 8138,01,Cook County",17,031,813801,Illinois
1110,1523,1306,217,1400000US17031813802,"Census Tract 8138,02,Cook County",17,031,813802,Illinois
1111,1833,1719,114,1400000US17031813900,"Census Tract 8139,Cook County",17,031,813900,Illinois
1112,1557,1388,169,1400000US17031814000,"Census Tract 8140,Cook County",17,031,814000,Illinois
1113,1435,1301,134,1400000US17031814100,"Census Tract 8141,Cook County",17,031,814100,Illinois
1114,2408,2183,225,1400000US17031814200,"Census Tract 8142,Cook County",17,031,814200,Illinois
1115,1630,1502,128,1400000US17031814300,"Census Tract 8143,Cook County",17,031,814300,Illinois
1116,2424,2404,20,1400000US17031814400,"Census Tract 8144,Cook County",17,031,814400,Illinois
1117,1563,1486,77,1400000US17031814500,"Census Tract 8145,Cook County",17,031,814500,Illinois
1118,1953,1727,226,1400000US17031814600,"Census Tract 8146,Cook County",17,031,814600,Illinois
1119,1849,1558,291,1400000US17031814700,"Census Tract 8147,Cook County",17,031,814700,Illinois
1120,2560,2387,173,1400000US17031814800,"Census Tract 8148,Cook County",17,031,814800,Illinois
1121,2950,2599,351,1400000US17031814900,"Census Tract 8149,Cook County",17,031,814900,Illinois
1122,1351,1295,56,1400000US17031815000,"Census Tract 8150,Cook County",17,031,815000,Illinois
1123,1559,1544,15,1400000US17031815100,"Census Tract 8151,Cook County",17,031,815100,Illinois
1124,2557,2433,124,1400000US17031815200,"Census Tract 8152,Cook County",17,031,815200,Illinois
1125,1444,1358,86,1400000US17031815300,"Census Tract 8153,Cook County",17,031,815300,Illinois
1126,2464,2332,132,1400000US17031815400,"Census Tract 8154,Cook County",17,031,815400,Illinois
1127,2594,2292,302,1400000US17031815500,"Census Tract 8155,Cook County",17,031,815500,Illinois
1128,2337,2177,160,1400000US17031815600,"Census Tract 8156,Cook County",17,031,815600,Illinois
1129,1558,1400,158,1400000US17031815701,"Census Tract 8157,01,Cook County",17,031,815701,Illinois
1130,2086,1977,109,1400000US17031815702,"Census Tract 8157,02,Cook County",17,031,815702,Illinois
1131,760,687,73,1400000US17031815800,"Census Tract 8158,Cook County",17,031,815800,Illinois
1132,2976,2755,221,1400000US17031815900,"Census Tract 8159,Cook County",17,031,815900,Illinois
1133,1804,1658,146,1400000US17031816000,"Census Tract 8160,Cook County",17,031,816000,Illinois
1134,2828,2548,280,1400000US17031816100,"Census Tract 8161,Cook County",17,031,816100,Illinois
1135,1764,1681,83,1400000US17031816200,"Census Tract 8162,Cook County",17,031,816200,Illinois
1136,1606,1529,77,1400000US17031816300,"Census Tract 8163,Cook County",17,031,816300,Illinois
1137,1342,1171,171,1400000US17031816401,"Census Tract 8164,01,Cook County",17,031,816401,Illinois
1138,1418,1303,115,1400000US17031816402,"Census Tract 8164,02,Cook County",17,031,816402,Illinois
1139,1499,1380,119,1400000US17031816500,"Census Tract 8165,Cook County",17,031,816500,Illinois
1140,1335,1225,110,1400000US17031816600,"Census Tract 8166,Cook County",17,031,816600,Illinois
1141,1020,967,53,1400000US17031816700,"Census Tract 8167,Cook County",17,031,816700,Illinois
1142,2114,2029,85,1400000US17031816800,"Census Tract 8168,Cook County",17,031,816800,Illinois
1143,1829,1806,23,1400000US17031816900,"Census Tract 8169,Cook County",17,031,816900,Illinois
1144,1767,1582,185,1400000US17031817000,"Census Tract 8170,Cook County",17,031,817000,Illinois
1145,1746,1622,124,1400000US17031817101,"Census Tract 8171,01,Cook County",17,031,817101,Illinois
1146,1092,1039,53,1400000US17031817102,"Census Tract 8171,02,Cook County",17,031,817102,Illinois
1147,1791,1499,292,1400000US17031817200,"Census Tract 8172,Cook County",17,031,817200,Illinois
1148,1024,802,222,1400000US17031817300,"Census Tract 8173,Cook County",17,031,817300,Illinois
1149,1248,1092,156,1400000US17031817400,"Census Tract 8174,Cook County",17,031,817400,Illinois
1150,1608,1369,239,1400000US17031817500,"Census Tract 8175,Cook County",17,031,817500,Illinois
1151,1406,1297,109,1400000US17031817600,"Census Tract 8176,Cook County",17,031,817600,Illinois
1152,1953,1816,137,1400000US17031817700,"Census Tract 8177,Cook County",17,031,817700,Illinois
1153,2391,2289,102,1400000US17031817900,"Census Tract 8179,Cook County",17,031,817900,Illinois
1154,1912,1841,71,1400000US17031818000,"Census Tract 8180,Cook County",17,031,818000,Illinois
1155,927,900,27,1400000US17031818100,"Census Tract 8181,Cook County",17,031,818100,Illinois
1156,1902,1859,43,1400000US17031818200,"Census Tract 8182,Cook County",17,031,818200,Illinois
1157,2089,1949,140,1400000US17031818300,"Census Tract 8183,Cook County",17,031,818300,Illinois
1158,1415,1382,33,1400000US17031818401,"Census Tract 8184,01,Cook County",17,031,818401,Illinois
1159,1591,1568,23,1400000US17031818402,"Census Tract 8184,02,Cook County",17,031,818402,Illinois
1160,2509,2343,166,1400000US17031818500,"Census Tract 8185,Cook County",17,031,818500,Illinois
1161,2108,1978,130,1400000US17031818600,"Census Tract 8186,Cook County",17,031,818600,Illinois
1162,1574,1518,56,1400000US17031818700,"Census Tract 8187,Cook County",17,031,818700,Illinois
1163,2265,2114,151,1400000US17031818800,"Census Tract 8188,Cook County",17,031,818800,Illinois
1164,2016,1874,142,1400000US17031818900,"Census Tract 8189,Cook County",17,031,818900,Illinois
1165,1682,1501,181,1400000US17031819000,"Census Tract 8190,Cook County",17,031,819000,Illinois
1166,2058,1881,177,1400000US17031819100,"Census Tract 8191,Cook County",17,031,819100,Illinois
1167,2301,2125,176,1400000US17031819200,"Census Tract 8192,Cook County",17,031,819200,Illinois
1168,1106,1021,85,1400000US17031819300,"Census Tract 8193,Cook County",17,031,819300,Illinois
1169,2331,2250,81,1400000US17031819400,"Census Tract 8194,Cook County",17,031,819400,Illinois
1170,1615,1485,130,1400000US17031819500,"Census Tract 8195,Cook County",17,031,819500,Illinois
1171,1360,1342,18,1400000US17031819600,"Census Tract 8196,Cook County",17,031,819600,Illinois
1172,1867,1771,96,1400000US17031819700,"Census Tract 8197,Cook County",17,031,819700,Illinois
1173,1691,1635,56,1400000US17031819801,"Census Tract 8198,01,Cook County",17,031,819801,Illinois
1174,949,934,15,1400000US17031819802,"Census Tract 8198,02,Cook County",17,031,819802,Illinois
1175,1071,1030,41,1400000US17031819900,"Census Tract 8199,Cook County",17,031,819900,Illinois
1176,718,661,57,1400000US17031820000,"Census Tract 8200,Cook County",17,031,820000,Illinois
1177,3458,3350,108,1400000US17031820101,"Census Tract 8201,01,Cook County",17,031,820101,Illinois
1178,1688,1664,24,1400000US17031820103,"Census Tract 8201,03,Cook County",17,031,820103,Illinois
1179,1876,1806,70,1400000US17031820104,"Census Tract 8201,04,Cook County",17,031,820104,Illinois
1180,1551,1348,203,1400000US17031820202,"Census Tract 8202,02,Cook County",17,031,820202,Illinois
1181,1305,1259,46,1400000US17031820203,"Census Tract 8202,03,Cook County",17,031,820203,Illinois
1182,2414,2168,246,1400000US17031820204,"Census Tract 8202,04,Cook County",17,031,820204,Illinois
1183,1792,1614,178,1400000US17031820300,"Census Tract 8203,Cook County",17,031,820300,Illinois
1184,1949,1802,147,1400000US17031820400,"Census Tract 8204,Cook County",17,031,820400,Illinois
1185,2119,1983,136,1400000US17031820501,"Census Tract 8205,01,Cook County",17,031,820501,Illinois
1186,2223,2147,76,1400000US17031820502,"Census Tract 8205,02,Cook County",17,031,820502,Illinois
1187,2072,1907,165,1400000US17031820603,"Census Tract 8206,03,Cook County",17,031,820603,Illinois
1188,1429,1266,163,1400000US17031820604,"Census Tract 8206,04,Cook County",17,031,820604,Illinois
1189,2179,1913,266,1400000US17031820605,"Census Tract 8206,05,Cook County",17,031,820605,Illinois
1190,1726,1620,106,1400000US17031820606,"Census Tract 8206,06,Cook County",17,031,820606,Illinois
1191,2579,2397,182,1400000US17031820700,"Census Tract 8207,Cook County",17,031,820700,Illinois
1192,1217,1139,78,1400000US17031820800,"Census Tract 8208,Cook County",17,031,820800,Illinois
1193,1889,1726,163,1400000US17031820901,"Census Tract 8209,01,Cook County",17,031,820901,Illinois
1194,1838,1726,112,1400000US17031820902,"Census Tract 8209,02,Cook County",17,031,820902,Illinois
1195,1725,1672,53,1400000US17031821001,"Census Tract 8210,01,Cook County",17,031,821001,Illinois
1196,1898,1814,84,1400000US17031821002,"Census Tract 8210,02,Cook County",17,031,821002,Illinois
1197,1450,1415,35,1400000US17031821101,"Census Tract 8211,01,Cook County",17,031,821101,Illinois
1198,1586,1550,36,1400000US17031821102,"Census Tract 8211,02,Cook County",17,031,821102,Illinois
1199,2393,2185,208,1400000US17031821200,"Census Tract 8212,Cook County",17,031,821200,Illinois
1200,2448,2211,237,1400000US17031821300,"Census Tract 8213,Cook County",17,031,821300,Illinois
1201,1344,1144,200,1400000US17031821401,"Census Tract 8214,01,Cook County",17,031,821401,Illinois
1202,1415,1253,162,1400000US17031821402,"Census Tract 8214,02,Cook County",17,031,821402,Illinois
1203,880,608,272,1400000US17031821500,"Census Tract 8215,Cook County",17,031,821500,Illinois
1204,1903,1841,62,1400000US17031821600,"Census Tract 8216,Cook County",17,031,821600,Illinois
1205,1869,1785,84,1400000US17031821700,"Census Tract 8217,Cook County",17,031,821700,Illinois
1206,2138,2085,53,1400000US17031821800,"Census Tract 8218,Cook County",17,031,821800,Illinois
1207,1852,1784,68,1400000US17031821900,"Census Tract 8219,Cook County",17,031,821900,Illinois
1208,1942,1895,47,1400000US17031822000,"Census Tract 8220,Cook County",17,031,822000,Illinois
1209,1721,1577,144,1400000US17031822101,"Census Tract 8221,01,Cook County",17,031,822101,Illinois
1210,2165,1962,203,1400000US17031822102,"Census Tract 8221,02,Cook County",17,031,822102,Illinois
1211,1362,1307,55,1400000US17031822200,"Census Tract 8222,Cook County",17,031,822200,Illinois
1212,1253,1165,88,1400000US17031822301,"Census Tract 8223,01,Cook County",17,031,822301,Illinois
1213,1730,1679,51,1400000US17031822302,"Census Tract 8223,02,Cook County",17,031,822302,Illinois
1214,2417,2115,302,1400000US17031822400,"Census Tract 8224,Cook County",17,031,822400,Illinois
1215,1730,1698,32,1400000US17031822500,"Census Tract 8225,Cook County",17,031,822500,Illinois
1216,1649,1603,46,1400000US17031822601,"Census Tract 8226,01,Cook County",17,031,822601,Illinois
1217,3262,3168,94,1400000US17031822602,"Census Tract 8226,02,Cook County",17,031,822602,Illinois
1218,2119,1974,145,1400000US17031822701,"Census Tract 8227,01,Cook County",17,031,822701,Illinois
1219,1657,1446,211,1400000US17031822702,"Census Tract 8227,02,Cook County",17,031,822702,Illinois
1220,1552,1476,76,1400000US17031822801,"Census Tract 8228,01,Cook County",17,031,822801,Illinois
1221,1408,1281,127,1400000US17031822802,"Census Tract 8228,02,Cook County",17,031,822802,Illinois
1222,886,819,67,1400000US17031822900,"Census Tract 8229,Cook County",17,031,822900,Illinois
1223,2923,2728,195,1400000US17031823001,"Census Tract 8230,01,Cook County",17,031,823001,Illinois
1224,2154,2032,122,1400000US17031823002,"Census Tract 8230,02,Cook County",17,031,823002,Illinois
1225,1877,1708,169,1400000US17031823101,"Census Tract 8231,01,Cook County",17,031,823101,Illinois
1226,1591,1509,82,1400000US17031823102,"Census Tract 8231,02,Cook County",17,031,823102,Illinois
1227,1954,1845,109,1400000US17031823200,"Census Tract 8232,Cook County",17,031,823200,Illinois
1228,2672,2470,202,1400000US17031823302,"Census Tract 8233,02,Cook County",17,031,823302,Illinois
1229,1641,1617,24,1400000US17031823303,"Census Tract 8233,03,Cook County",17,031,823303,Illinois
1230,2828,2634,194,1400000US17031823304,"Census Tract 8233,04,Cook County",17,031,823304,Illinois
1231,2056,1888,168,1400000US17031823400,"Census Tract 8234,Cook County",17,031,823400,Illinois
1232,1681,1499,182,1400000US17031823500,"Census Tract 8235,Cook County",17,031,823500,Illinois
1233,3073,2803,270,1400000US17031823602,"Census Tract 8236,02,Cook County",17,031,823602,Illinois
1234,678,545,133,1400000US17031823603,"Census Tract 8236,03,Cook County",17,031,823603,Illinois
1235,1210,1160,50,1400000US17031823604,"Census Tract 8236,04,Cook County",17,031,823604,Illinois
1236,1488,1380,108,1400000US17031823605,"Census Tract 8236,05,Cook County",17,031,823605,Illinois
1237,2952,2691,261,1400000US17031823702,"Census Tract 8237,02,Cook County",17,031,823702,Illinois
1238,3173,2928,245,1400000US17031823703,"Census Tract 8237,03,Cook County",17,031,823703,Illinois
1239,1406,1365,41,1400000US17031823704,"Census Tract 8237,04,Cook County",17,031,823704,Illinois
1240,1641,1624,17,1400000US17031823705,"Census Tract 8237,05,Cook County",17,031,823705,Illinois
1241,2519,2065,454,1400000US17031823801,"Census Tract 8238,01,Cook County",17,031,823801,Illinois
1242,2869,2739,130,1400000US17031823803,"Census Tract 8238,03,Cook County",17,031,823803,Illinois
1243,1608,1582,26,1400000US17031823805,"Census Tract 8238,05,Cook County",17,031,823805,Illinois
1244,1828,1761,67,1400000US17031823806,"Census Tract 8238,06,Cook County",17,031,823806,Illinois
1245,1740,1629,111,1400000US17031823901,"Census Tract 8239,01,Cook County",17,031,823901,Illinois
1246,1782,1713,69,1400000US17031823903,"Census Tract 8239,03,Cook County",17,031,823903,Illinois
1247,1710,1591,119,1400000US17031823904,"Census Tract 8239,04,Cook County",17,031,823904,Illinois
1248,2095,2011,84,1400000US17031824003,"Census Tract 8240,03,Cook County",17,031,824003,Illinois
1249,2134,1932,202,1400000US17031824004,"Census Tract 8240,04,Cook County",17,031,824004,Illinois
1250,2030,1976,54,1400000US17031824005,"Census Tract 8240,05,Cook County",17,031,824005,Illinois
1251,1865,1834,31,1400000US17031824006,"Census Tract 8240,06,Cook County",17,031,824006,Illinois
1252,2922,2723,199,1400000US17031824105,"Census Tract 8241,05,Cook County",17,031,824105,Illinois
1253,2516,2425,91,1400000US17031824106,"Census Tract 8241,06,Cook County",17,031,824106,Illinois
1254,2818,2802,16,1400000US17031824107,"Census Tract 8241,07,Cook County",17,031,824107,Illinois
1255,2379,2337,42,1400000US17031824113,"Census Tract 8241,13,Cook County",17,031,824113,Illinois
1256,1924,1854,70,1400000US17031824114,"Census Tract 8241,14,Cook County",17,031,824114,Illinois
1257,1627,1534,93,1400000US17031824115,"Census Tract 8241,15,Cook County",17,031,824115,Illinois
1258,2406,2317,89,1400000US17031824116,"Census Tract 8241,16,Cook County",17,031,824116,Illinois
1259,2328,2230,98,1400000US17031824119,"Census Tract 8241,19,Cook County",17,031,824119,Illinois
1260,1339,1302,37,1400000US17031824121,"Census Tract 8241,21,Cook County",17,031,824121,Illinois
1261,2405,2365,40,1400000US17031824122,"Census Tract 8241,22,Cook County",17,031,824122,Illinois
1262,2981,2771,210,1400000US17031824123,"Census Tract 8241,23,Cook County",17,031,824123,Illinois
1263,1150,1109,41,1400000US17031824124,"Census Tract 8241,24,Cook County",17,031,824124,Illinois
1264,1471,1430,41,1400000US17031824125,"Census Tract 8241,25,Cook County",17,031,824125,Illinois
1265,2065,2065,0,1400000US17031824126,"Census Tract 8241,26,Cook County",17,031,824126,Illinois
1266,1512,1440,72,1400000US17031824127,"Census Tract 8241,27,Cook County",17,031,824127,Illinois
1267,1754,1683,71,1400000US17031824128,"Census Tract 8241,28,Cook County",17,031,824128,Illinois
1268,1730,1627,103,1400000US17031824129,"Census Tract 8241,29,Cook County",17,031,824129,Illinois
1269,1820,1493,327,1400000US17031824300,"Census Tract 8243,Cook County",17,031,824300,Illinois
1270,807,691,116,1400000US17031824400,"Census Tract 8244,Cook County",17,031,824400,Illinois
1271,2794,2538,256,1400000US17031824503,"Census Tract 8245,03,Cook County",17,031,824503,Illinois
1272,2619,2544,75,1400000US17031824505,"Census Tract 8245,05,Cook County",17,031,824505,Illinois
1273,1839,1758,81,1400000US17031824507,"Census Tract 8245,07,Cook County",17,031,824507,Illinois
1274,1720,1615,105,1400000US17031824508,"Census Tract 8245,08,Cook County",17,031,824508,Illinois
1275,1619,1619,0,1400000US17031824509,"Census Tract 8245,09,Cook County",17,031,824509,Illinois
1276,1676,1588,88,1400000US17031824601,"Census Tract 8246,01,Cook County",17,031,824601,Illinois
1277,2564,2494,70,1400000US17031824602,"Census Tract 8246,02,Cook County",17,031,824602,Illinois
1278,1506,1476,30,1400000US17031824701,"Census Tract 8247,01,Cook County",17,031,824701,Illinois
1279,2324,2209,115,1400000US17031824702,"Census Tract 8247,02,Cook County",17,031,824702,Illinois
1280,2391,2258,133,1400000US17031824800,"Census Tract 8248,Cook County",17,031,824800,Illinois
1281,1129,1068,61,1400000US17031824900,"Census Tract 8249,Cook County",17,031,824900,Illinois
1282,1968,1899,69,1400000US17031825000,"Census Tract 8250,Cook County",17,031,825000,Illinois
1283,752,752,0,1400000US17031825200,"Census Tract 8252,Cook County",17,031,825200,Illinois
1284,2396,2232,164,1400000US17031825302,"Census Tract 8253,02,Cook County",17,031,825302,Illinois
1285,1734,1608,126,1400000US17031825303,"Census Tract 8253,03,Cook County",17,031,825303,Illinois
1286,1663,1663,0,1400000US17031825304,"Census Tract 8253,04,Cook County",17,031,825304,Illinois
1287,2694,2478,216,1400000US17031825400,"Census Tract 8254,Cook County",17,031,825400,Illinois
1288,2078,1829,249,1400000US17031825501,"Census Tract 8255,01,Cook County",17,031,825501,Illinois
1289,2741,2490,251,1400000US17031825503,"Census Tract 8255,03,Cook County",17,031,825503,Illinois
1290,1404,1301,103,1400000US17031825504,"Census Tract 8255,04,Cook County",17,031,825504,Illinois
1291,1893,1737,156,1400000US17031825505,"Census Tract 8255,05,Cook County",17,031,825505,Illinois
1292,1725,1545,180,1400000US17031825600,"Census Tract 8256,Cook County",17,031,825600,Illinois
1293,1741,1594,147,1400000US17031825700,"Census Tract 8257,Cook County",17,031,825700,Illinois
1294,1859,1483,376,1400000US17031825801,"Census Tract 8258,01,Cook County",17,031,825801,Illinois
1295,2389,2215,174,1400000US17031825802,"Census Tract 8258,02,Cook County",17,031,825802,Illinois
1296,2562,2329,233,1400000US17031825803,"Census Tract 8258,03,Cook County",17,031,825803,Illinois
1297,1273,1112,161,1400000US17031825900,"Census Tract 8259,Cook County",17,031,825900,Illinois
1298,1407,931,476,1400000US17031826000,"Census Tract 8260,Cook County",17,031,826000,Illinois
1299,2539,2020,519,1400000US17031826100,"Census Tract 8261,Cook County",17,031,826100,Illinois
1300,2359,2119,240,1400000US17031826201,"Census Tract 8262,01,Cook County",17,031,826201,Illinois
1301,2218,1913,305,1400000US17031826202,"Census Tract 8262,02,Cook County",17,031,826202,Illinois
1302,1575,1520,55,1400000US17031826301,"Census Tract 8263,01,Cook County",17,031,826301,Illinois
1303,1339,1182,157,1400000US17031826303,"Census Tract 8263,03,Cook County",17,031,826303,Illinois
1304,1466,1260,206,1400000US17031826304,"Census Tract 8263,04,Cook County",17,031,826304,Illinois
1305,1457,1306,151,1400000US17031826401,"Census Tract 8264,01,Cook County",17,031,826401,Illinois
1306,1947,1707,240,1400000US17031826402,"Census Tract 8264,02,Cook County",17,031,826402,Illinois
1307,2357,2045,312,1400000US17031826500,"Census Tract 8265,Cook County",17,031,826500,Illinois
1308,2109,1612,497,1400000US17031826600,"Census Tract 8266,Cook County",17,031,826600,Illinois
1309,2306,1731,575,1400000US17031826700,"Census Tract 8267,Cook County",17,031,826700,Illinois
1310,1908,1549,359,1400000US17031826800,"Census Tract 8268,Cook County",17,031,826800,Illinois
1311,938,681,257,1400000US17031826901,"Census Tract 8269,01,Cook County",17,031,826901,Illinois
1312,634,406,228,1400000US17031826902,"Census Tract 8269,02,Cook County",17,031,826902,Illinois
1313,1565,1255,310,1400000US17031827000,"Census Tract 8270,Cook County",17,031,827000,Illinois
1314,1182,886,296,1400000US17031827100,"Census Tract 8271,Cook County",17,031,827100,Illinois
1315,1547,1342,205,1400000US17031827200,"Census Tract 8272,Cook County",17,031,827200,Illinois
1316,1206,844,362,1400000US17031827300,"Census Tract 8273,Cook County",17,031,827300,Illinois
1317,1642,1161,481,1400000US17031827400,"Census Tract 8274,Cook County",17,031,827400,Illinois
1318,1812,1388,424,1400000US17031827500,"Census Tract 8275,Cook County",17,031,827500,Illinois
1319,1152,891,261,1400000US17031827600,"Census Tract 8276,Cook County",17,031,827600,Illinois
1320,1092,875,217,1400000US17031827700,"Census Tract 8277,Cook County",17,031,827700,Illinois
1321,1791,1652,139,1400000US17031827801,"Census Tract 8278,01,Cook County",17,031,827801,Illinois
1322,1056,933,123,1400000US17031827802,"Census Tract 8278,02,Cook County",17,031,827802,Illinois
1323,1336,1285,51,1400000US17031827804,"Census Tract 8278,04,Cook County",17,031,827804,Illinois
1324,1036,994,42,1400000US17031827805,"Census Tract 8278,05,Cook County",17,031,827805,Illinois
1325,748,735,13,1400000US17031827901,"Census Tract 8279,01,Cook County",17,031,827901,Illinois
1326,1741,1577,164,1400000US17031827902,"Census Tract 8279,02,Cook County",17,031,827902,Illinois
1327,2265,2101,164,1400000US17031828000,"Census Tract 8280,Cook County",17,031,828000,Illinois
1328,2221,2037,184,1400000US17031828100,"Census Tract 8281,Cook County",17,031,828100,Illinois
1329,1739,1532,207,1400000US17031828201,"Census Tract 8282,01,Cook County",17,031,828201,Illinois
1330,2024,1925,99,1400000US17031828202,"Census Tract 8282,02,Cook County",17,031,828202,Illinois
1331,1489,1419,70,1400000US17031828300,"Census Tract 8283,Cook County",17,031,828300,Illinois
1332,1503,1397,106,1400000US17031828401,"Census Tract 8284,01,Cook County",17,031,828401,Illinois
1333,1705,1555,150,1400000US17031828402,"Census Tract 8284,02,Cook County",17,031,828402,Illinois
1334,1883,1531,352,1400000US17031828503,"Census Tract 8285,03,Cook County",17,031,828503,Illinois
1335,2065,1670,395,1400000US17031828504,"Census Tract 8285,04,Cook County",17,031,828504,Illinois
1336,2817,2662,155,1400000US17031828505,"Census Tract 8285,05,Cook County",17,031,828505,Illinois
1337,1460,1227,233,1400000US17031828507,"Census Tract 8285,07,Cook County",17,031,828507,Illinois
1338,1783,1522,261,1400000US17031828508,"Census Tract 8285,08,Cook County",17,031,828508,Illinois
1339,1729,1720,9,1400000US17031828601,"Census Tract 8286,01,Cook County",17,031,828601,Illinois
1340,1564,1447,117,1400000US17031828602,"Census Tract 8286,02,Cook County",17,031,828602,Illinois
1341,1553,1408,145,1400000US17031828701,"Census Tract 8287,01,Cook County",17,031,828701,Illinois
1342,1768,1595,173,1400000US17031828702,"Census Tract 8287,02,Cook County",17,031,828702,Illinois
1343,1851,1762,89,1400000US17031828801,"Census Tract 8288,01,Cook County",17,031,828801,Illinois
1344,1113,1074,39,1400000US17031828802,"Census Tract 8288,02,Cook County",17,031,828802,Illinois
1345,1344,1166,178,1400000US17031828900,"Census Tract 8289,Cook County",17,031,828900,Illinois
1346,503,314,189,1400000US17031829000,"Census Tract 8290,Cook County",17,031,829000,Illinois
1347,1454,1204,250,1400000US17031829100,"Census Tract 8291,Cook County",17,031,829100,Illinois
1348,2203,1886,317,1400000US17031829200,"Census Tract 8292,Cook County",17,031,829200,Illinois
1349,1522,1407,115,1400000US17031829301,"Census Tract 8293,01,Cook County",17,031,829301,Illinois
1350,1260,1103,157,1400000US17031829302,"Census Tract 8293,02,Cook County",17,031,829302,Illinois
1351,452,330,122,1400000US17031829401,"Census Tract 8294,01,Cook County",17,031,829401,Illinois
1352,1388,1249,139,1400000US17031829402,"Census Tract 8294,02,Cook County",17,031,829402,Illinois
1353,1666,1556,110,1400000US17031829500,"Census Tract 8295,Cook County",17,031,829500,Illinois
1354,1292,1152,140,1400000US17031829600,"Census Tract 8296,Cook County",17,031,829600,Illinois
1355,1362,1015,347,1400000US17031829700,"Census Tract 8297,Cook County",17,031,829700,Illinois
1356,2370,2234,136,1400000US17031829800,"Census Tract 8298,Cook County",17,031,829800,Illinois
1357,2625,2536,89,1400000US17031829902,"Census Tract 8299,02,Cook County",17,031,829902,Illinois
1358,1746,1600,146,1400000US17031829903,"Census Tract 8299,03,Cook County",17,031,829903,Illinois
1359,2072,1965,107,1400000US17031829904,"Census Tract 8299,04,Cook County",17,031,829904,Illinois
1360,1272,1137,135,1400000US17031830001,"Census Tract 8300,01,Cook County",17,031,830001,Illinois
1361,2903,2822,81,1400000US17031830003,"Census Tract 8300,03,Cook County",17,031,830003,Illinois
1362,2688,2502,186,1400000US17031830004,"Census Tract 8300,04,Cook County",17,031,830004,Illinois
1363,1768,1622,146,1400000US17031830005,"Census Tract 8300,05,Cook County",17,031,830005,Illinois
1364,1357,1252,105,1400000US17031830006,"Census Tract 8300,06,Cook County",17,031,830006,Illinois
1365,1962,1882,80,1400000US17031830007,"Census Tract 8300,07,Cook County",17,031,830007,Illinois
1366,1484,1440,44,1400000US17031830008,"Census Tract 8300,08,Cook County",17,031,830008,Illinois
1367,1072,971,101,1400000US17031830100,"Census Tract 8301,Cook County",17,031,830100,Illinois
1368,2347,2086,261,1400000US17031830201,"Census Tract 8302,01,Cook County",17,031,830201,Illinois
1369,1187,1100,87,1400000US17031830202,"Census Tract 8302,02,Cook County",17,031,830202,Illinois
1370,2346,2248,98,1400000US17031830300,"Census Tract 8303,Cook County",17,031,830300,Illinois
1371,1884,1589,295,1400000US17031830400,"Census Tract 8304,Cook County",17,031,830400,Illinois
1372,1192,1137,55,1400000US17031830500,"Census Tract 8305,Cook County",17,031,830500,Illinois
1373,2299,2127,172,1400000US17031830600,"Census Tract 8306,Cook County",17,031,830600,Illinois
1374,2108,1919,189,1400000US17031830700,"Census Tract 8307,Cook County",17,031,830700,Illinois
1375,1562,1505,57,1400000US17031830800,"Census Tract 8308,Cook County",17,031,830800,Illinois
1376,1418,1305,113,1400000US17031830900,"Census Tract 8309,Cook County",17,031,830900,Illinois
1377,1171,1037,134,1400000US17031831000,"Census Tract 8310,Cook County",17,031,831000,Illinois
1378,2998,2671,327,1400000US17031831100,"Census Tract 8311,Cook County",17,031,831100,Illinois
1379,1732,1560,172,1400000US17031831200,"Census Tract 8312,Cook County",17,031,831200,Illinois
1380,419,381,38,1400000US17031831300,"Census Tract 8313,Cook County",17,031,831300,Illinois
1381,1193,1031,162,1400000US17031831400,"Census Tract 8314,Cook County",17,031,831400,Illinois
1382,1506,1360,146,1400000US17031831500,"Census Tract 8315,Cook County",17,031,831500,Illinois
1383,2715,2519,196,1400000US17031831600,"Census Tract 8316,Cook County",17,031,831600,Illinois
1384,967,917,50,1400000US17031831700,"Census Tract 8317,Cook County",17,031,831700,Illinois
1385,2803,2506,297,1400000US17031831800,"Census Tract 8318,Cook County",17,031,831800,Illinois
1386,1659,1507,152,1400000US17031831900,"Census Tract 8319,Cook County",17,031,831900,Illinois
1387,1105,977,128,1400000US17031832000,"Census Tract 8320,Cook County",17,031,832000,Illinois
1388,2027,1818,209,1400000US17031832100,"Census Tract 8321,Cook County",17,031,832100,Illinois
1389,1669,1487,182,1400000US17031832200,"Census Tract 8322,Cook County",17,031,832200,Illinois
1390,1067,981,86,1400000US17031832300,"Census Tract 8323,Cook County",17,031,832300,Illinois
1391,1730,1498,232,1400000US17031832400,"Census Tract 8324,Cook County",17,031,832400,Illinois
1392,1577,1396,181,1400000US17031832500,"Census Tract 8325,Cook County",17,031,832500,Illinois
1393,1920,1728,192,1400000US17031832600,"Census Tract 8326,Cook County",17,031,832600,Illinois
1394,832,691,141,1400000US17031832900,"Census Tract 8329,Cook County",17,031,832900,Illinois
1395,2970,2731,239,1400000US17031833000,"Census Tract 8330,Cook County",17,031,833000,Illinois
1396,4737,4373,364,1400000US17031833100,"Census Tract 8331,Cook County",17,031,833100,Illinois
1397,1329,1157,172,1400000US17031833300,"Census Tract 8333,Cook County",17,031,833300,Illinois
1398,1077,823,254,1400000US17031833900,"Census Tract 8339,Cook County",17,031,833900,Illinois
1399,1434,1124,310,1400000US17031834000,"Census Tract 8340,Cook County",17,031,834000,Illinois
1400,2675,1980,695,1400000US17031834200,"Census Tract 8342,Cook County",17,031,834200,Illinois
1401,3072,2633,439,1400000US17031834300,"Census Tract 8343,Cook County",17,031,834300,Illinois
1402,2127,1896,231,1400000US17031834400,"Census Tract 8344,Cook County",17,031,834400,Illinois
1403,673,482,191,1400000US17031834500,"Census Tract 8345,Cook County",17,031,834500,Illinois
1404,1123,778,345,1400000US17031834600,"Census Tract 8346,Cook County",17,031,834600,Illinois
1405,989,566,423,1400000US17031834700,"Census Tract 8347,Cook County",17,031,834700,Illinois
1406,1059,752,307,1400000US17031834800,"Census Tract 8348,Cook County",17,031,834800,Illinois
1407,856,586,270,1400000US17031834900,"Census Tract 8349,Cook County",17,031,834900,Illinois
1408,2106,1952,154,1400000US17031835000,"Census Tract 8350,Cook County",17,031,835000,Illinois
1409,1503,1331,172,1400000US17031835100,"Census Tract 8351,Cook County",17,031,835100,Illinois
1410,686,657,29,1400000US17031835200,"Census Tract 8352,Cook County",17,031,835200,Illinois
1411,949,679,270,1400000US17031835500,"Census Tract 8355,Cook County",17,031,835500,Illinois
1412,619,451,168,1400000US17031835600,"Census Tract 8356,Cook County",17,031,835600,Illinois
1413,813,733,80,1400000US17031835800,"Census Tract 8358,Cook County",17,031,835800,Illinois
1414,1203,1068,135,1400000US17031836000,"Census Tract 8360,Cook County",17,031,836000,Illinois
1415,962,759,203,1400000US17031836100,"Census Tract 8361,Cook County",17,031,836100,Illinois
1416,132,98,34,1400000US17031836200,"Census Tract 8362,Cook County",17,031,836200,Illinois
1417,757,674,83,1400000US17031836300,"Census Tract 8363,Cook County",17,031,836300,Illinois
1418,2000,1865,135,1400000US17031836400,"Census Tract 8364,Cook County",17,031,836400,Illinois
1419,823,774,49,1400000US17031836500,"Census Tract 8365,Cook County",17,031,836500,Illinois
1420,1158,928,230,1400000US17031836600,"Census Tract 8366,Cook County",17,031,836600,Illinois
1421,1145,1057,88,1400000US17031836700,"Census Tract 8367,Cook County",17,031,836700,Illinois
1422,1101,906,195,1400000US17031836800,"Census Tract 8368,Cook County",17,031,836800,Illinois
1423,664,585,79,1400000US17031836900,"Census Tract 8369,Cook County",17,031,836900,Illinois
1424,986,778,208,1400000US17031837000,"Census Tract 8370,Cook County",17,031,837000,Illinois
1425,851,713,138,1400000US17031837100,"Census Tract 8371,Cook County",17,031,837100,Illinois
1426,1065,927,138,1400000US17031837300,"Census Tract 8373,Cook County",17,031,837300,Illinois
1427,864,703,161,1400000US17031837400,"Census Tract 8374,Cook County",17,031,837400,Illinois
1428,1296,1108,188,1400000US17031837800,"Census Tract 8378,Cook County",17,031,837800,Illinois
1429,1568,1396,172,1400000US17031838000,"Census Tract 8380,Cook County",17,031,838000,Illinois
1430,1332,1021,311,1400000US17031838100,"Census Tract 8381,Cook County",17,031,838100,Illinois
1431,427,371,56,1400000US17031838200,"Census Tract 8382,Cook County",17,031,838200,Illinois
1432,1284,1103,181,1400000US17031838300,"Census Tract 8383,Cook County",17,031,838300,Illinois
1433,686,631,55,1400000US17031838600,"Census Tract 8386,Cook County",17,031,838600,Illinois
1434,2003,1516,487,1400000US17031838700,"Census Tract 8387,Cook County",17,031,838700,Illinois
1435,1303,1136,167,1400000US17031838800,"Census Tract 8388,Cook County",17,031,838800,Illinois
1436,6579,5768,811,1400000US17031839000,"Census Tract 8390,Cook County",17,031,839000,Illinois
1437,5334,4652,682,1400000US17031839100,"Census Tract 8391,Cook County",17,031,839100,Illinois
1438,1579,1429,150,1400000US17031839200,"Census Tract 8392,Cook County",17,031,839200,Illinois
1439,862,748,114,1400000US17031839500,"Census Tract 8395,Cook County",17,031,839500,Illinois
1440,1081,926,155,1400000US17031839600,"Census Tract 8396,Cook County",17,031,839600,Illinois
1441,1976,1848,128,1400000US17031839700,"Census Tract 8397,Cook County",17,031,839700,Illinois
1442,1211,1085,126,1400000US17031839800,"Census Tract 8398,Cook County",17,031,839800,Illinois
1443,2198,2110,88,1400000US17031839900,"Census Tract 8399,Cook County",17,031,839900,Illinois
1444,1108,1064,44,1400000US17031840000,"Census Tract 8400,Cook County",17,031,840000,Illinois
1445,1196,1140,56,1400000US17031840100,"Census Tract 8401,Cook County",17,031,840100,Illinois
1446,854,822,32,1400000US17031840200,"Census Tract 8402,Cook County",17,031,840200,Illinois
1447,1345,1221,124,1400000US17031840300,"Census Tract 8403,Cook County",17,031,840300,Illinois
1448,1164,1140,24,1400000US17031840400,"Census Tract 8404,Cook County",17,031,840400,Illinois
1449,1279,1153,126,1400000US17031840700,"Census Tract 8407,Cook County",17,031,840700,Illinois
1450,949,885,64,1400000US17031840800,"Census Tract 8408,Cook County",17,031,840800,Illinois
1451,676,634,42,1400000US17031841000,"Census Tract 8410,Cook County",17,031,841000,Illinois
1452,2981,2810,171,1400000US17031841100,"Census Tract 8411,Cook County",17,031,841100,Illinois
1453,1888,1648,240,1400000US17031841200,"Census Tract 8412,Cook County",17,031,841200,Illinois
1454,1950,1843,107,1400000US17031841300,"Census Tract 8413,Cook County",17,031,841300,Illinois
1455,1103,807,296,1400000US17031841500,"Census Tract 8415,Cook County",17,031,841500,Illinois
1456,833,601,232,1400000US17031841700,"Census Tract 8417,Cook County",17,031,841700,Illinois
1457,1146,904,242,1400000US17031841800,"Census Tract 8418,Cook County",17,031,841800,Illinois
1458,1781,1549,232,1400000US17031841900,"Census Tract 8419,Cook County",17,031,841900,Illinois
1459,375,358,17,1400000US17031842000,"Census Tract 8420,Cook County",17,031,842000,Illinois
1460,2189,2079,110,1400000US17031842100,"Census Tract 8421,Cook County",17,031,842100,Illinois
1461,2547,2287,260,1400000US17031842200,"Census Tract 8422,Cook County",17,031,842200,Illinois
1462,1692,1591,101,1400000US17031842300,"Census Tract 8423,Cook County",17,031,842300,Illinois
1463,1578,1433,145,1400000US17031842400,"Census Tract 8424,Cook County",17,031,842400,Illinois
1464,972,897,75,1400000US17031842500,"Census Tract 8425,Cook County",17,031,842500,Illinois
1465,1750,1517,233,1400000US17031842600,"Census Tract 8426,Cook County",17,031,842600,Illinois
1466,2278,1922,356,1400000US17031842800,"Census Tract 8428,Cook County",17,031,842800,Illinois
1467,1483,1434,49,1400000US17031842900,"Census Tract 8429,Cook County",17,031,842900,Illinois
1468,1242,1036,206,1400000US17031843000,"Census Tract 8430,Cook County",17,031,843000,Illinois
1469,579,426,153,1400000US17031843100,"Census Tract 8431,Cook County",17,031,843100,Illinois
1470,1074,960,114,1400000US17031843200,"Census Tract 8432,Cook County",17,031,843200,Illinois
1471,468,375,93,1400000US17031843300,"Census Tract 8433,Cook County",17,031,843300,Illinois
1472,536,459,77,1400000US17031843400,"Census Tract 8434,Cook County",17,031,843400,Illinois
1473,272,232,40,1400000US17031843500,"Census Tract 8435,Cook County",17,031,843500,Illinois
1474,1662,1503,159,1400000US17031843600,"Census Tract 8436,Cook County",17,031,843600,Illinois
1475,1074,1040,34,1400000US17031843700,"Census Tract 8437,Cook County",17,031,843700,Illinois
1476,845,704,141,1400000US17031843800,"Census Tract 8438,Cook County",17,031,843800,Illinois
1477,2381,2073,308,1400000US17031843900,"Census Tract 8439,Cook County",17,031,843900,Illinois
1478,952,809,143,1400000US17031844600,"Census Tract 8446,Cook County",17,031,844600,Illinois
1479,858,653,205,1400000US17031844700,"Census Tract 8447,Cook County",17,031,844700,Illinois
1480,0,0,0,1400000US17031980000,"Census Tract 9800,Cook County",17,031,980000,Illinois
1481,0,0,0,1400000US17031980100,"Census Tract 9801,Cook County",17,031,980100,Illinois
1482,0,0,0,1400000US17031990000,"Census Tract 9900,Cook County",17,031,990000,Illinois
1483,1258,1137,121,1400000US17033880100,"Census Tract 8801,Crawford County",17,033,880100,Illinois
1484,1622,1490,132,1400000US17033880200,"Census Tract 8802,Crawford County",17,033,880200,Illinois
1485,1708,1442,266,1400000US17033880300,"Census Tract 8803,Crawford County",17,033,880300,Illinois
1486,1418,1172,246,1400000US17033880400,"Census Tract 8804,Crawford County",17,033,880400,Illinois
1487,1122,1023,99,1400000US17033880500,"Census Tract 8805,Crawford County",17,033,880500,Illinois
1488,1369,1248,121,1400000US17033880600,"Census Tract 8806,Crawford County",17,033,880600,Illinois
1489,1467,1273,194,1400000US17035972400,"Census Tract 9724,Cumberland County",17,035,972400,Illinois
1490,1429,1267,162,1400000US17035972500,"Census Tract 9725,Cumberland County",17,035,972500,Illinois
1491,1840,1586,254,1400000US17035972600,"Census Tract 9726,Cumberland County",17,035,972600,Illinois
1492,2560,2516,44,1400000US17037000100,"Census Tract 1,DeKalb County",17,037,000100,Illinois
1493,1919,1838,81,1400000US17037000200,"Census Tract 2,DeKalb County",17,037,000200,Illinois
1494,1091,1014,77,1400000US17037000300,"Census Tract 3,DeKalb County",17,037,000300,Illinois
1495,1699,1699,0,1400000US17037000401,"Census Tract 4,01,DeKalb County",17,037,000401,Illinois
1496,1440,1397,43,1400000US17037000402,"Census Tract 4,02,DeKalb County",17,037,000402,Illinois
1497,1906,1727,179,1400000US17037000500,"Census Tract 5,DeKalb County",17,037,000500,Illinois
1498,2423,2255,168,1400000US17037000600,"Census Tract 6,DeKalb County",17,037,000600,Illinois
1499,1714,1669,45,1400000US17037000700,"Census Tract 7,DeKalb County",17,037,000700,Illinois
1500,2666,2562,104,1400000US17037000800,"Census Tract 8,DeKalb County",17,037,000800,Illinois
1501,2297,2153,144,1400000US17037000900,"Census Tract 9,DeKalb County",17,037,000900,Illinois
1502,3589,3245,344,1400000US17037001002,"Census Tract 10,02,DeKalb County",17,037,001002,Illinois
1503,1942,1562,380,1400000US17037001003,"Census Tract 10,03,DeKalb County",17,037,001003,Illinois
1504,764,680,84,1400000US17037001004,"Census Tract 10,04,DeKalb County",17,037,001004,Illinois
1505,2488,2356,132,1400000US17037001300,"Census Tract 13,DeKalb County",17,037,001300,Illinois
1506,2471,2471,0,1400000US17037001400,"Census Tract 14,DeKalb County",17,037,001400,Illinois
1507,1466,1446,20,1400000US17037001500,"Census Tract 15,DeKalb County",17,037,001500,Illinois
1508,1773,1704,69,1400000US17037001600,"Census Tract 16,DeKalb County",17,037,001600,Illinois
1509,1434,1330,104,1400000US17037001700,"Census Tract 17,DeKalb County",17,037,001700,Illinois
1510,1571,1459,112,1400000US17037001800,"Census Tract 18,DeKalb County",17,037,001800,Illinois
1511,945,899,46,1400000US17037001900,"Census Tract 19,DeKalb County",17,037,001900,Illinois
1512,1738,1678,60,1400000US17037002000,"Census Tract 20,DeKalb County",17,037,002000,Illinois
1513,971,919,52,1400000US17037002100,"Census Tract 21,DeKalb County",17,037,002100,Illinois
1514,422,352,70,1400000US17037002200,"Census Tract 22,DeKalb County",17,037,002200,Illinois
1515,1104,990,114,1400000US17039971400,"Census Tract 9714,De Witt County",17,039,971400,Illinois
1516,1138,1021,117,1400000US17039971500,"Census Tract 9715,De Witt County",17,039,971500,Illinois
1517,1704,1552,152,1400000US17039971600,"Census Tract 9716,De Witt County",17,039,971600,Illinois
1518,1611,1542,69,1400000US17039971700,"Census Tract 9717,De Witt County",17,039,971700,Illinois
1519,1793,1530,263,1400000US17039971800,"Census Tract 9718,De Witt County",17,039,971800,Illinois
1520,1170,965,205,1400000US17041952000,"Census Tract 9520,Douglas County",17,041,952000,Illinois
1521,1928,1700,228,1400000US17041952100,"Census Tract 9521,Douglas County",17,041,952100,Illinois
1522,2233,2058,175,1400000US17041952200,"Census Tract 9522,Douglas County",17,041,952200,Illinois
1523,1885,1701,184,1400000US17041952300,"Census Tract 9523,Douglas County",17,041,952300,Illinois
1524,1247,1161,86,1400000US17041952400,"Census Tract 9524,Douglas County",17,041,952400,Illinois
1525,943,937,6,1400000US17043840000,"Census Tract 8400,DuPage County",17,043,840000,Illinois
1526,1862,1812,50,1400000US17043840101,"Census Tract 8401,01,DuPage County",17,043,840101,Illinois
1527,1747,1706,41,1400000US17043840102,"Census Tract 8401,02,DuPage County",17,043,840102,Illinois
1528,2300,2195,105,1400000US17043840103,"Census Tract 8401,03,DuPage County",17,043,840103,Illinois
1529,2330,2236,94,1400000US17043840104,"Census Tract 8401,04,DuPage County",17,043,840104,Illinois
1530,2856,2707,149,1400000US17043840201,"Census Tract 8402,01,DuPage County",17,043,840201,Illinois
1531,1919,1879,40,1400000US17043840202,"Census Tract 8402,02,DuPage County",17,043,840202,Illinois
1532,1473,1423,50,1400000US17043840303,"Census Tract 8403,03,DuPage County",17,043,840303,Illinois
1533,1464,1453,11,1400000US17043840304,"Census Tract 8403,04,DuPage County",17,043,840304,Illinois
1534,1909,1822,87,1400000US17043840600,"Census Tract 8406,DuPage County",17,043,840600,Illinois
1535,1694,1632,62,1400000US17043840703,"Census Tract 8407,03,DuPage County",17,043,840703,Illinois
1536,1250,1208,42,1400000US17043840704,"Census Tract 8407,04,DuPage County",17,043,840704,Illinois
1537,1223,1167,56,1400000US17043840705,"Census Tract 8407,05,DuPage County",17,043,840705,Illinois
1538,1175,1169,6,1400000US17043840706,"Census Tract 8407,06,DuPage County",17,043,840706,Illinois
1539,956,956,0,1400000US17043840801,"Census Tract 8408,01,DuPage County",17,043,840801,Illinois
1540,2283,2159,124,1400000US17043840802,"Census Tract 8408,02,DuPage County",17,043,840802,Illinois
1541,1646,1590,56,1400000US17043840901,"Census Tract 8409,01,DuPage County",17,043,840901,Illinois
1542,1642,1531,111,1400000US17043840904,"Census Tract 8409,04,DuPage County",17,043,840904,Illinois
1543,1130,1017,113,1400000US17043840906,"Census Tract 8409,06,DuPage County",17,043,840906,Illinois
1544,1987,1973,14,1400000US17043840907,"Census Tract 8409,07,DuPage County",17,043,840907,Illinois
1545,1599,1524,75,1400000US17043840908,"Census Tract 8409,08,DuPage County",17,043,840908,Illinois
1546,1641,1569,72,1400000US17043840910,"Census Tract 8409,10,DuPage County",17,043,840910,Illinois
1547,860,814,46,1400000US17043840911,"Census Tract 8409,11,DuPage County",17,043,840911,Illinois
1548,1226,1189,37,1400000US17043841002,"Census Tract 8410,02,DuPage County",17,043,841002,Illinois
1549,1543,1493,50,1400000US17043841003,"Census Tract 8410,03,DuPage County",17,043,841003,Illinois
1550,1643,1643,0,1400000US17043841004,"Census Tract 8410,04,DuPage County",17,043,841004,Illinois
1551,2229,2177,52,1400000US17043841102,"Census Tract 8411,02,DuPage County",17,043,841102,Illinois
1552,1523,1454,69,1400000US17043841103,"Census Tract 8411,03,DuPage County",17,043,841103,Illinois
1553,1570,1481,89,1400000US17043841104,"Census Tract 8411,04,DuPage County",17,043,841104,Illinois
1554,1456,1403,53,1400000US17043841108,"Census Tract 8411,08,DuPage County",17,043,841108,Illinois
1555,1503,1503,0,1400000US17043841109,"Census Tract 8411,09,DuPage County",17,043,841109,Illinois
1556,1394,1316,78,1400000US17043841110,"Census Tract 8411,10,DuPage County",17,043,841110,Illinois
1557,1548,1507,41,1400000US17043841111,"Census Tract 8411,11,DuPage County",17,043,841111,Illinois
1558,1323,1228,95,1400000US17043841112,"Census Tract 8411,12,DuPage County",17,043,841112,Illinois
1559,1308,1287,21,1400000US17043841113,"Census Tract 8411,13,DuPage County",17,043,841113,Illinois
1560,1809,1653,156,1400000US17043841114,"Census Tract 8411,14,DuPage County",17,043,841114,Illinois
1561,1855,1767,88,1400000US17043841204,"Census Tract 8412,04,DuPage County",17,043,841204,Illinois
1562,1499,1499,0,1400000US17043841205,"Census Tract 8412,05,DuPage County",17,043,841205,Illinois
1563,2063,1992,71,1400000US17043841206,"Census Tract 8412,06,DuPage County",17,043,841206,Illinois
1564,854,834,20,1400000US17043841207,"Census Tract 8412,07,DuPage County",17,043,841207,Illinois
1565,2009,1869,140,1400000US17043841208,"Census Tract 8412,08,DuPage County",17,043,841208,Illinois
1566,1590,1569,21,1400000US17043841209,"Census Tract 8412,09,DuPage County",17,043,841209,Illinois
1567,1742,1675,67,1400000US17043841210,"Census Tract 8412,10,DuPage County",17,043,841210,Illinois
1568,1937,1873,64,1400000US17043841307,"Census Tract 8413,07,DuPage County",17,043,841307,Illinois
1569,1585,1576,9,1400000US17043841308,"Census Tract 8413,08,DuPage County",17,043,841308,Illinois
1570,1059,1059,0,1400000US17043841310,"Census Tract 8413,10,DuPage County",17,043,841310,Illinois
1571,1366,1258,108,1400000US17043841312,"Census Tract 8413,12,DuPage County",17,043,841312,Illinois
1572,1105,1043,62,1400000US17043841313,"Census Tract 8413,13,DuPage County",17,043,841313,Illinois
1573,2038,1996,42,1400000US17043841314,"Census Tract 8413,14,DuPage County",17,043,841314,Illinois
1574,1092,1056,36,1400000US17043841315,"Census Tract 8413,15,DuPage County",17,043,841315,Illinois
1575,1213,1187,26,1400000US17043841316,"Census Tract 8413,16,DuPage County",17,043,841316,Illinois
1576,955,937,18,1400000US17043841318,"Census Tract 8413,18,DuPage County",17,043,841318,Illinois
1577,908,887,21,1400000US17043841320,"Census Tract 8413,20,DuPage County",17,043,841320,Illinois
1578,823,823,0,1400000US17043841321,"Census Tract 8413,21,DuPage County",17,043,841321,Illinois
1579,1498,1493,5,1400000US17043841322,"Census Tract 8413,22,DuPage County",17,043,841322,Illinois
1580,1019,1019,0,1400000US17043841323,"Census Tract 8413,23,DuPage County",17,043,841323,Illinois
1581,890,885,5,1400000US17043841324,"Census Tract 8413,24,DuPage County",17,043,841324,Illinois
1582,1914,1891,23,1400000US17043841325,"Census Tract 8413,25,DuPage County",17,043,841325,Illinois
1583,1263,1223,40,1400000US17043841326,"Census Tract 8413,26,DuPage County",17,043,841326,Illinois
1584,1313,1285,28,1400000US17043841327,"Census Tract 8413,27,DuPage County",17,043,841327,Illinois
1585,2171,2075,96,1400000US17043841401,"Census Tract 8414,01,DuPage County",17,043,841401,Illinois
1586,1612,1548,64,1400000US17043841403,"Census Tract 8414,03,DuPage County",17,043,841403,Illinois
1587,1270,1270,0,1400000US17043841404,"Census Tract 8414,04,DuPage County",17,043,841404,Illinois
1588,1625,1595,30,1400000US17043841501,"Census Tract 8415,01,DuPage County",17,043,841501,Illinois
1589,996,980,16,1400000US17043841503,"Census Tract 8415,03,DuPage County",17,043,841503,Illinois
1590,1157,1105,52,1400000US17043841504,"Census Tract 8415,04,DuPage County",17,043,841504,Illinois
1591,1819,1776,43,1400000US17043841603,"Census Tract 8416,03,DuPage County",17,043,841603,Illinois
1592,1511,1406,105,1400000US17043841604,"Census Tract 8416,04,DuPage County",17,043,841604,Illinois
1593,1273,1217,56,1400000US17043841605,"Census Tract 8416,05,DuPage County",17,043,841605,Illinois
1594,917,859,58,1400000US17043841606,"Census Tract 8416,06,DuPage County",17,043,841606,Illinois
1595,1912,1813,99,1400000US17043841607,"Census Tract 8416,07,DuPage County",17,043,841607,Illinois
1596,1587,1568,19,1400000US17043841704,"Census Tract 8417,04,DuPage County",17,043,841704,Illinois
1597,2500,2442,58,1400000US17043841705,"Census Tract 8417,05,DuPage County",17,043,841705,Illinois
1598,1604,1515,89,1400000US17043841706,"Census Tract 8417,06,DuPage County",17,043,841706,Illinois
1599,1642,1475,167,1400000US17043841707,"Census Tract 8417,07,DuPage County",17,043,841707,Illinois
1600,1822,1734,88,1400000US17043841708,"Census Tract 8417,08,DuPage County",17,043,841708,Illinois
1601,1935,1872,63,1400000US17043841801,"Census Tract 8418,01,DuPage County",17,043,841801,Illinois
1602,1940,1913,27,1400000US17043841802,"Census Tract 8418,02,DuPage County",17,043,841802,Illinois
1603,903,903,0,1400000US17043841901,"Census Tract 8419,01,DuPage County",17,043,841901,Illinois
1604,782,762,20,1400000US17043841902,"Census Tract 8419,02,DuPage County",17,043,841902,Illinois
1605,1494,1468,26,1400000US17043842000,"Census Tract 8420,DuPage County",17,043,842000,Illinois
1606,2428,2319,109,1400000US17043842100,"Census Tract 8421,DuPage County",17,043,842100,Illinois
1607,2005,1968,37,1400000US17043842200,"Census Tract 8422,DuPage County",17,043,842200,Illinois
1608,1280,1238,42,1400000US17043842300,"Census Tract 8423,DuPage County",17,043,842300,Illinois
1609,1822,1715,107,1400000US17043842400,"Census Tract 8424,DuPage County",17,043,842400,Illinois
1610,1904,1685,219,1400000US17043842500,"Census Tract 8425,DuPage County",17,043,842500,Illinois
1611,1501,1434,67,1400000US17043842601,"Census Tract 8426,01,DuPage County",17,043,842601,Illinois
1612,1568,1473,95,1400000US17043842602,"Census Tract 8426,02,DuPage County",17,043,842602,Illinois
1613,1443,1335,108,1400000US17043842603,"Census Tract 8426,03,DuPage County",17,043,842603,Illinois
1614,2072,2025,47,1400000US17043842604,"Census Tract 8426,04,DuPage County",17,043,842604,Illinois
1615,1649,1542,107,1400000US17043842605,"Census Tract 8426,05,DuPage County",17,043,842605,Illinois
1616,2111,2015,96,1400000US17043842702,"Census Tract 8427,02,DuPage County",17,043,842702,Illinois
1617,1548,1458,90,1400000US17043842703,"Census Tract 8427,03,DuPage County",17,043,842703,Illinois
1618,2297,2144,153,1400000US17043842704,"Census Tract 8427,04,DuPage County",17,043,842704,Illinois
1619,1899,1812,87,1400000US17043842706,"Census Tract 8427,06,DuPage County",17,043,842706,Illinois
1620,917,897,20,1400000US17043842708,"Census Tract 8427,08,DuPage County",17,043,842708,Illinois
1621,1259,1231,28,1400000US17043842709,"Census Tract 8427,09,DuPage County",17,043,842709,Illinois
1622,1730,1665,65,1400000US17043842710,"Census Tract 8427,10,DuPage County",17,043,842710,Illinois
1623,1004,927,77,1400000US17043842711,"Census Tract 8427,11,DuPage County",17,043,842711,Illinois
1624,1840,1780,60,1400000US17043842800,"Census Tract 8428,DuPage County",17,043,842800,Illinois
1625,2210,2145,65,1400000US17043842900,"Census Tract 8429,DuPage County",17,043,842900,Illinois
1626,1756,1679,77,1400000US17043843000,"Census Tract 8430,DuPage County",17,043,843000,Illinois
1627,1911,1753,158,1400000US17043843100,"Census Tract 8431,DuPage County",17,043,843100,Illinois
1628,2119,2019,100,1400000US17043843200,"Census Tract 8432,DuPage County",17,043,843200,Illinois
1629,1309,1271,38,1400000US17043843301,"Census Tract 8433,01,DuPage County",17,043,843301,Illinois
1630,1212,1162,50,1400000US17043843302,"Census Tract 8433,02,DuPage County",17,043,843302,Illinois
1631,1234,1172,62,1400000US17043843400,"Census Tract 8434,DuPage County",17,043,843400,Illinois
1632,2264,2137,127,1400000US17043843500,"Census Tract 8435,DuPage County",17,043,843500,Illinois
1633,1309,1295,14,1400000US17043843601,"Census Tract 8436,01,DuPage County",17,043,843601,Illinois
1634,1150,1140,10,1400000US17043843602,"Census Tract 8436,02,DuPage County",17,043,843602,Illinois
1635,1585,1493,92,1400000US17043843700,"Census Tract 8437,DuPage County",17,043,843700,Illinois
1636,1487,1402,85,1400000US17043843800,"Census Tract 8438,DuPage County",17,043,843800,Illinois
1637,1466,1466,0,1400000US17043843900,"Census Tract 8439,DuPage County",17,043,843900,Illinois
1638,1313,1261,52,1400000US17043844001,"Census Tract 8440,01,DuPage County",17,043,844001,Illinois
1639,1389,1351,38,1400000US17043844002,"Census Tract 8440,02,DuPage County",17,043,844002,Illinois
1640,1355,1344,11,1400000US17043844100,"Census Tract 8441,DuPage County",17,043,844100,Illinois
1641,2093,1922,171,1400000US17043844201,"Census Tract 8442,01,DuPage County",17,043,844201,Illinois
1642,856,834,22,1400000US17043844202,"Census Tract 8442,02,DuPage County",17,043,844202,Illinois
1643,1817,1678,139,1400000US17043844304,"Census Tract 8443,04,DuPage County",17,043,844304,Illinois
1644,2155,1873,282,1400000US17043844305,"Census Tract 8443,05,DuPage County",17,043,844305,Illinois
1645,2716,2236,480,1400000US17043844306,"Census Tract 8443,06,DuPage County",17,043,844306,Illinois
1646,1540,1447,93,1400000US17043844307,"Census Tract 8443,07,DuPage County",17,043,844307,Illinois
1647,1352,1307,45,1400000US17043844308,"Census Tract 8443,08,DuPage County",17,043,844308,Illinois
1648,799,799,0,1400000US17043844309,"Census Tract 8443,09,DuPage County",17,043,844309,Illinois
1649,1379,1289,90,1400000US17043844310,"Census Tract 8443,10,DuPage County",17,043,844310,Illinois
1650,1450,1328,122,1400000US17043844401,"Census Tract 8444,01,DuPage County",17,043,844401,Illinois
1651,1864,1710,154,1400000US17043844402,"Census Tract 8444,02,DuPage County",17,043,844402,Illinois
1652,1283,1237,46,1400000US17043844501,"Census Tract 8445,01,DuPage County",17,043,844501,Illinois
1653,1696,1605,91,1400000US17043844502,"Census Tract 8445,02,DuPage County",17,043,844502,Illinois
1654,1704,1595,109,1400000US17043844601,"Census Tract 8446,01,DuPage County",17,043,844601,Illinois
1655,2641,2283,358,1400000US17043844602,"Census Tract 8446,02,DuPage County",17,043,844602,Illinois
1656,1699,1606,93,1400000US17043844701,"Census Tract 8447,01,DuPage County",17,043,844701,Illinois
1657,2052,1860,192,1400000US17043844702,"Census Tract 8447,02,DuPage County",17,043,844702,Illinois
1658,1563,1531,32,1400000US17043844801,"Census Tract 8448,01,DuPage County",17,043,844801,Illinois
1659,1601,1437,164,1400000US17043844802,"Census Tract 8448,02,DuPage County",17,043,844802,Illinois
1660,1633,1499,134,1400000US17043844901,"Census Tract 8449,01,DuPage County",17,043,844901,Illinois
1661,1710,1689,21,1400000US17043844902,"Census Tract 8449,02,DuPage County",17,043,844902,Illinois
1662,2486,2395,91,1400000US17043845000,"Census Tract 8450,DuPage County",17,043,845000,Illinois
1663,2118,2034,84,1400000US17043845100,"Census Tract 8451,DuPage County",17,043,845100,Illinois
1664,1619,1576,43,1400000US17043845200,"Census Tract 8452,DuPage County",17,043,845200,Illinois
1665,1066,953,113,1400000US17043845300,"Census Tract 8453,DuPage County",17,043,845300,Illinois
1666,1423,1386,37,1400000US17043845401,"Census Tract 8454,01,DuPage County",17,043,845401,Illinois
1667,1254,1244,10,1400000US17043845402,"Census Tract 8454,02,DuPage County",17,043,845402,Illinois
1668,2682,2488,194,1400000US17043845502,"Census Tract 8455,02,DuPage County",17,043,845502,Illinois
1669,1627,1459,168,1400000US17043845505,"Census Tract 8455,05,DuPage County",17,043,845505,Illinois
1670,1900,1674,226,1400000US17043845506,"Census Tract 8455,06,DuPage County",17,043,845506,Illinois
1671,1347,1310,37,1400000US17043845507,"Census Tract 8455,07,DuPage County",17,043,845507,Illinois
1672,1871,1764,107,1400000US17043845508,"Census Tract 8455,08,DuPage County",17,043,845508,Illinois
1673,1329,1300,29,1400000US17043845509,"Census Tract 8455,09,DuPage County",17,043,845509,Illinois
1674,1645,1538,107,1400000US17043845510,"Census Tract 8455,10,DuPage County",17,043,845510,Illinois
1675,1808,1704,104,1400000US17043845601,"Census Tract 8456,01,DuPage County",17,043,845601,Illinois
1676,2077,1991,86,1400000US17043845602,"Census Tract 8456,02,DuPage County",17,043,845602,Illinois
1677,1713,1669,44,1400000US17043845701,"Census Tract 8457,01,DuPage County",17,043,845701,Illinois
1678,1675,1631,44,1400000US17043845702,"Census Tract 8457,02,DuPage County",17,043,845702,Illinois
1679,1933,1866,67,1400000US17043845703,"Census Tract 8457,03,DuPage County",17,043,845703,Illinois
1680,2279,2125,154,1400000US17043845704,"Census Tract 8457,04,DuPage County",17,043,845704,Illinois
1681,1645,1611,34,1400000US17043845802,"Census Tract 8458,02,DuPage County",17,043,845802,Illinois
1682,2364,2197,167,1400000US17043845803,"Census Tract 8458,03,DuPage County",17,043,845803,Illinois
1683,1764,1713,51,1400000US17043845805,"Census Tract 8458,05,DuPage County",17,043,845805,Illinois
1684,2671,2632,39,1400000US17043845807,"Census Tract 8458,07,DuPage County",17,043,845807,Illinois
1685,1330,1296,34,1400000US17043845808,"Census Tract 8458,08,DuPage County",17,043,845808,Illinois
1686,1686,1643,43,1400000US17043845809,"Census Tract 8458,09,DuPage County",17,043,845809,Illinois
1687,1832,1747,85,1400000US17043845810,"Census Tract 8458,10,DuPage County",17,043,845810,Illinois
1688,1482,1402,80,1400000US17043845811,"Census Tract 8458,11,DuPage County",17,043,845811,Illinois
1689,1296,1182,114,1400000US17043845901,"Census Tract 8459,01,DuPage County",17,043,845901,Illinois
1690,1413,1245,168,1400000US17043845902,"Census Tract 8459,02,DuPage County",17,043,845902,Illinois
1691,2649,2613,36,1400000US17043846002,"Census Tract 8460,02,DuPage County",17,043,846002,Illinois
1692,1864,1856,8,1400000US17043846003,"Census Tract 8460,03,DuPage County",17,043,846003,Illinois
1693,1776,1634,142,1400000US17043846004,"Census Tract 8460,04,DuPage County",17,043,846004,Illinois
1694,2163,1973,190,1400000US17043846102,"Census Tract 8461,02,DuPage County",17,043,846102,Illinois
1695,1940,1862,78,1400000US17043846103,"Census Tract 8461,03,DuPage County",17,043,846103,Illinois
1696,1499,1464,35,1400000US17043846104,"Census Tract 8461,04,DuPage County",17,043,846104,Illinois
1697,1480,1422,58,1400000US17043846105,"Census Tract 8461,05,DuPage County",17,043,846105,Illinois
1698,1630,1592,38,1400000US17043846106,"Census Tract 8461,06,DuPage County",17,043,846106,Illinois
1699,2497,2334,163,1400000US17043846201,"Census Tract 8462,01,DuPage County",17,043,846201,Illinois
1700,2455,2339,116,1400000US17043846202,"Census Tract 8462,02,DuPage County",17,043,846202,Illinois
1701,1549,1487,62,1400000US17043846203,"Census Tract 8462,03,DuPage County",17,043,846203,Illinois
1702,1213,1213,0,1400000US17043846205,"Census Tract 8462,05,DuPage County",17,043,846205,Illinois
1703,1590,1457,133,1400000US17043846206,"Census Tract 8462,06,DuPage County",17,043,846206,Illinois
1704,1918,1888,30,1400000US17043846207,"Census Tract 8462,07,DuPage County",17,043,846207,Illinois
1705,1243,1180,63,1400000US17043846208,"Census Tract 8462,08,DuPage County",17,043,846208,Illinois
1706,1304,1304,0,1400000US17043846209,"Census Tract 8462,09,DuPage County",17,043,846209,Illinois
1707,2164,1980,184,1400000US17043846304,"Census Tract 8463,04,DuPage County",17,043,846304,Illinois
1708,2105,2057,48,1400000US17043846305,"Census Tract 8463,05,DuPage County",17,043,846305,Illinois
1709,2024,1932,92,1400000US17043846307,"Census Tract 8463,07,DuPage County",17,043,846307,Illinois
1710,1608,1544,64,1400000US17043846308,"Census Tract 8463,08,DuPage County",17,043,846308,Illinois
1711,1796,1630,166,1400000US17043846310,"Census Tract 8463,10,DuPage County",17,043,846310,Illinois
1712,2055,2008,47,1400000US17043846311,"Census Tract 8463,11,DuPage County",17,043,846311,Illinois
1713,3037,2802,235,1400000US17043846312,"Census Tract 8463,12,DuPage County",17,043,846312,Illinois
1714,2233,2233,0,1400000US17043846313,"Census Tract 8463,13,DuPage County",17,043,846313,Illinois
1715,1619,1619,0,1400000US17043846314,"Census Tract 8463,14,DuPage County",17,043,846314,Illinois
1716,1567,1495,72,1400000US17043846315,"Census Tract 8463,15,DuPage County",17,043,846315,Illinois
1717,2738,2709,29,1400000US17043846404,"Census Tract 8464,04,DuPage County",17,043,846404,Illinois
1718,1742,1603,139,1400000US17043846405,"Census Tract 8464,05,DuPage County",17,043,846405,Illinois
1719,1373,1361,12,1400000US17043846408,"Census Tract 8464,08,DuPage County",17,043,846408,Illinois
1720,1662,1662,0,1400000US17043846409,"Census Tract 8464,09,DuPage County",17,043,846409,Illinois
1721,2254,2254,0,1400000US17043846410,"Census Tract 8464,10,DuPage County",17,043,846410,Illinois
1722,2211,2077,134,1400000US17043846411,"Census Tract 8464,11,DuPage County",17,043,846411,Illinois
1723,2018,1841,177,1400000US17043846412,"Census Tract 8464,12,DuPage County",17,043,846412,Illinois
1724,1654,1535,119,1400000US17043846413,"Census Tract 8464,13,DuPage County",17,043,846413,Illinois
1725,2448,2333,115,1400000US17043846504,"Census Tract 8465,04,DuPage County",17,043,846504,Illinois
1726,1549,1392,157,1400000US17043846507,"Census Tract 8465,07,DuPage County",17,043,846507,Illinois
1727,2806,2462,344,1400000US17043846509,"Census Tract 8465,09,DuPage County",17,043,846509,Illinois
1728,1424,1424,0,1400000US17043846510,"Census Tract 8465,10,DuPage County",17,043,846510,Illinois
1729,2010,1890,120,1400000US17043846511,"Census Tract 8465,11,DuPage County",17,043,846511,Illinois
1730,1017,1017,0,1400000US17043846513,"Census Tract 8465,13,DuPage County",17,043,846513,Illinois
1731,1377,1336,41,1400000US17043846514,"Census Tract 8465,14,DuPage County",17,043,846514,Illinois
1732,1871,1733,138,1400000US17043846515,"Census Tract 8465,15,DuPage County",17,043,846515,Illinois
1733,2237,1941,296,1400000US17043846517,"Census Tract 8465,17,DuPage County",17,043,846517,Illinois
1734,1099,1099,0,1400000US17043846518,"Census Tract 8465,18,DuPage County",17,043,846518,Illinois
1735,1390,1335,55,1400000US17043846519,"Census Tract 8465,19,DuPage County",17,043,846519,Illinois
1736,2184,1804,380,1400000US17043846521,"Census Tract 8465,21,DuPage County",17,043,846521,Illinois
1737,1497,1473,24,1400000US17043846522,"Census Tract 8465,22,DuPage County",17,043,846522,Illinois
1738,911,896,15,1400000US17043846523,"Census Tract 8465,23,DuPage County",17,043,846523,Illinois
1739,1809,1761,48,1400000US17043846524,"Census Tract 8465,24,DuPage County",17,043,846524,Illinois
1740,1260,1235,25,1400000US17043846603,"Census Tract 8466,03,DuPage County",17,043,846603,Illinois
1741,1502,1463,39,1400000US17043846604,"Census Tract 8466,04,DuPage County",17,043,846604,Illinois
1742,1513,1473,40,1400000US17043846701,"Census Tract 8467,01,DuPage County",17,043,846701,Illinois
1743,1313,1260,53,1400000US17043846702,"Census Tract 8467,02,DuPage County",17,043,846702,Illinois
1744,1126,984,142,1400000US17045070100,"Census Tract 701,Edgar County",17,045,070100,Illinois
1745,925,789,136,1400000US17045070200,"Census Tract 702,Edgar County",17,045,070200,Illinois
1746,1956,1708,248,1400000US17045070300,"Census Tract 703,Edgar County",17,045,070300,Illinois
1747,2661,2578,83,1400000US17045070400,"Census Tract 704,Edgar County",17,045,070400,Illinois
1748,1638,1485,153,1400000US17045070500,"Census Tract 705,Edgar County",17,045,070500,Illinois
1749,1061,839,222,1400000US17047956900,"Census Tract 9569,Edwards County",17,047,956900,Illinois
1750,1041,926,115,1400000US17047957000,"Census Tract 9570,Edwards County",17,047,957000,Illinois
1751,951,891,60,1400000US17047957100,"Census Tract 9571,Edwards County",17,047,957100,Illinois
1752,1894,1644,250,1400000US17049950100,"Census Tract 9501,Effingham County",17,049,950100,Illinois
1753,2222,1923,299,1400000US17049950200,"Census Tract 9502,Effingham County",17,049,950200,Illinois
1754,1842,1791,51,1400000US17049950300,"Census Tract 9503,Effingham County",17,049,950300,Illinois
1755,1640,1513,127,1400000US17049950400,"Census Tract 9504,Effingham County",17,049,950400,Illinois
1756,1845,1778,67,1400000US17049950500,"Census Tract 9505,Effingham County",17,049,950500,Illinois
1757,2395,2260,135,1400000US17049950600,"Census Tract 9506,Effingham County",17,049,950600,Illinois
1758,1560,1492,68,1400000US17049950700,"Census Tract 9507,Effingham County",17,049,950700,Illinois
1759,1839,1703,136,1400000US17049950800,"Census Tract 9508,Effingham County",17,049,950800,Illinois
1760,1229,1071,158,1400000US17051950500,"Census Tract 9505,Fayette County",17,051,950500,Illinois
1761,1109,925,184,1400000US17051950600,"Census Tract 9506,Fayette County",17,051,950600,Illinois
1762,1751,1560,191,1400000US17051950700,"Census Tract 9507,Fayette County",17,051,950700,Illinois
1763,1483,1386,97,1400000US17051950800,"Census Tract 9508,Fayette County",17,051,950800,Illinois
1764,1081,757,324,1400000US17051950900,"Census Tract 9509,Fayette County",17,051,950900,Illinois
1765,958,782,176,1400000US17051951000,"Census Tract 9510,Fayette County",17,051,951000,Illinois
1766,1276,1128,148,1400000US17051951100,"Census Tract 9511,Fayette County",17,051,951100,Illinois
1767,974,863,111,1400000US17053961600,"Census Tract 9616,Ford County",17,053,961600,Illinois
1768,843,770,73,1400000US17053961700,"Census Tract 9617,Ford County",17,053,961700,Illinois
1769,1995,1791,204,1400000US17053961800,"Census Tract 9618,Ford County",17,053,961800,Illinois
1770,759,646,113,1400000US17053961900,"Census Tract 9619,Ford County",17,053,961900,Illinois
1771,1710,1649,61,1400000US17053962000,"Census Tract 9620,Ford County",17,053,962000,Illinois
1772,1292,1093,199,1400000US17055040100,"Census Tract 401,Franklin County",17,055,040100,Illinois
1773,1503,1351,152,1400000US17055040200,"Census Tract 402,Franklin County",17,055,040200,Illinois
1774,1552,1353,199,1400000US17055040300,"Census Tract 403,Franklin County",17,055,040300,Illinois
1775,1795,1587,208,1400000US17055040400,"Census Tract 404,Franklin County",17,055,040400,Illinois
1776,1497,1290,207,1400000US17055040500,"Census Tract 405,Franklin County",17,055,040500,Illinois
1777,1323,1178,145,1400000US17055040600,"Census Tract 406,Franklin County",17,055,040600,Illinois
1778,2268,1909,359,1400000US17055040700,"Census Tract 407,Franklin County",17,055,040700,Illinois
1779,1518,1423,95,1400000US17055040800,"Census Tract 408,Franklin County",17,055,040800,Illinois
1780,1204,1039,165,1400000US17055040900,"Census Tract 409,Franklin County",17,055,040900,Illinois
1781,1426,1181,245,1400000US17055041000,"Census Tract 410,Franklin County",17,055,041000,Illinois
1782,1376,1282,94,1400000US17055041100,"Census Tract 411,Franklin County",17,055,041100,Illinois
1783,1767,1551,216,1400000US17055041200,"Census Tract 412,Franklin County",17,055,041200,Illinois
1784,1129,1010,119,1400000US17057952800,"Census Tract 9528,Fulton County",17,057,952800,Illinois
1785,1354,1274,80,1400000US17057952900,"Census Tract 9529,Fulton County",17,057,952900,Illinois
1786,1096,913,183,1400000US17057953000,"Census Tract 9530,Fulton County",17,057,953000,Illinois
1787,1064,948,116,1400000US17057953100,"Census Tract 9531,Fulton County",17,057,953100,Illinois
1788,1295,1029,266,1400000US17057953200,"Census Tract 9532,Fulton County",17,057,953200,Illinois
1789,1702,1590,112,1400000US17057953300,"Census Tract 9533,Fulton County",17,057,953300,Illinois
1790,954,756,198,1400000US17057953400,"Census Tract 9534,Fulton County",17,057,953400,Illinois
1791,1133,1017,116,1400000US17057953500,"Census Tract 9535,Fulton County",17,057,953500,Illinois
1792,2377,2190,187,1400000US17057953600,"Census Tract 9536,Fulton County",17,057,953600,Illinois
1793,1212,1022,190,1400000US17057953700,"Census Tract 9537,Fulton County",17,057,953700,Illinois
1794,1158,988,170,1400000US17057953800,"Census Tract 9538,Fulton County",17,057,953800,Illinois
1795,1410,1156,254,1400000US17057953900,"Census Tract 9539,Fulton County",17,057,953900,Illinois
1796,1198,1021,177,1400000US17059972700,"Census Tract 9727,Gallatin County",17,059,972700,Illinois
1797,1330,1112,218,1400000US17059972800,"Census Tract 9728,Gallatin County",17,059,972800,Illinois
1798,1356,1029,327,1400000US17061973600,"Census Tract 9736,Greene County",17,061,973600,Illinois
1799,814,631,183,1400000US17061973700,"Census Tract 9737,Greene County",17,061,973700,Illinois
1800,959,684,275,1400000US17061973800,"Census Tract 9738,Greene County",17,061,973800,Illinois
1801,1182,893,289,1400000US17061973900,"Census Tract 9739,Greene County",17,061,973900,Illinois
1802,1547,1275,272,1400000US17061974000,"Census Tract 9740,Greene County",17,061,974000,Illinois
1803,2844,2775,69,1400000US17063000102,"Census Tract 1,02,Grundy County",17,063,000102,Illinois
1804,2436,2436,0,1400000US17063000103,"Census Tract 1,03,Grundy County",17,063,000103,Illinois
1805,2815,2727,88,1400000US17063000200,"Census Tract 2,Grundy County",17,063,000200,Illinois
1806,1494,1453,41,1400000US17063000300,"Census Tract 3,Grundy County",17,063,000300,Illinois
1807,2606,2498,108,1400000US17063000400,"Census Tract 4,Grundy County",17,063,000400,Illinois
1808,1188,1138,50,1400000US17063000500,"Census Tract 5,Grundy County",17,063,000500,Illinois
1809,1241,1150,91,1400000US17063000600,"Census Tract 6,Grundy County",17,063,000600,Illinois
1810,2732,2563,169,1400000US17063000700,"Census Tract 7,Grundy County",17,063,000700,Illinois
1811,2089,2028,61,1400000US17063000800,"Census Tract 8,Grundy County",17,063,000800,Illinois
1812,1601,1391,210,1400000US17063000900,"Census Tract 9,Grundy County",17,063,000900,Illinois
1813,1454,1214,240,1400000US17065973100,"Census Tract 9731,Hamilton County",17,065,973100,Illinois
1814,1172,945,227,1400000US17065973200,"Census Tract 9732,Hamilton County",17,065,973200,Illinois
1815,1221,1031,190,1400000US17065973300,"Census Tract 9733,Hamilton County",17,065,973300,Illinois
1816,1025,856,169,1400000US17067953700,"Census Tract 9537,Hancock County",17,067,953700,Illinois
1817,1491,1260,231,1400000US17067953800,"Census Tract 9538,Hancock County",17,067,953800,Illinois
1818,939,765,174,1400000US17067953900,"Census Tract 9539,Hancock County",17,067,953900,Illinois
1819,1294,820,474,1400000US17067954000,"Census Tract 9540,Hancock County",17,067,954000,Illinois
1820,1383,1250,133,1400000US17067954100,"Census Tract 9541,Hancock County",17,067,954100,Illinois
1821,1195,996,199,1400000US17067954200,"Census Tract 9542,Hancock County",17,067,954200,Illinois
1822,1653,1421,232,1400000US17067954300,"Census Tract 9543,Hancock County",17,067,954300,Illinois
1823,1012,764,248,1400000US17069970900,"Census Tract 9709,Hardin County",17,069,970900,Illinois
1824,1227,737,490,1400000US17069971000,"Census Tract 9710,Hardin County",17,069,971000,Illinois
1825,1249,957,292,1400000US17071973300,"Census Tract 9733,Henderson County",17,071,973300,Illinois
1826,1011,800,211,1400000US17071973400,"Census Tract 9734,Henderson County",17,071,973400,Illinois
1827,1163,939,224,1400000US17071973500,"Census Tract 9735,Henderson County",17,071,973500,Illinois
1828,2632,2457,175,1400000US17073030100,"Census Tract 301,Henry County",17,073,030100,Illinois
1829,1661,1609,52,1400000US17073030201,"Census Tract 302,01,Henry County",17,073,030201,Illinois
1830,1432,1316,116,1400000US17073030202,"Census Tract 302,02,Henry County",17,073,030202,Illinois
1831,1831,1761,70,1400000US17073030203,"Census Tract 302,03,Henry County",17,073,030203,Illinois
1832,1834,1724,110,1400000US17073030301,"Census Tract 303,01,Henry County",17,073,030301,Illinois
1833,1686,1466,220,1400000US17073030302,"Census Tract 303,02,Henry County",17,073,030302,Illinois
1834,1188,1128,60,1400000US17073030400,"Census Tract 304,Henry County",17,073,030400,Illinois
1835,975,882,93,1400000US17073030500,"Census Tract 305,Henry County",17,073,030500,Illinois
1836,1443,1255,188,1400000US17073030600,"Census Tract 306,Henry County",17,073,030600,Illinois
1837,1491,1193,298,1400000US17073030800,"Census Tract 308,Henry County",17,073,030800,Illinois
1838,1788,1620,168,1400000US17073030900,"Census Tract 309,Henry County",17,073,030900,Illinois
1839,1586,1361,225,1400000US17073031000,"Census Tract 310,Henry County",17,073,031000,Illinois
1840,1246,1105,141,1400000US17073031100,"Census Tract 311,Henry County",17,073,031100,Illinois
1841,1411,1232,179,1400000US17073031200,"Census Tract 312,Henry County",17,073,031200,Illinois
1842,1316,1151,165,1400000US17075950100,"Census Tract 9501,Iroquois County",17,075,950100,Illinois
1843,1554,1496,58,1400000US17075950200,"Census Tract 9502,Iroquois County",17,075,950200,Illinois
1844,1448,1243,205,1400000US17075950300,"Census Tract 9503,Iroquois County",17,075,950300,Illinois
1845,1812,1514,298,1400000US17075950400,"Census Tract 9504,Iroquois County",17,075,950400,Illinois
1846,1780,1658,122,1400000US17075950500,"Census Tract 9505,Iroquois County",17,075,950500,Illinois
1847,1402,1154,248,1400000US17075950600,"Census Tract 9506,Iroquois County",17,075,950600,Illinois
1848,1419,1123,296,1400000US17075950700,"Census Tract 9507,Iroquois County",17,075,950700,Illinois
1849,1069,958,111,1400000US17075950800,"Census Tract 9508,Iroquois County",17,075,950800,Illinois
1850,1065,945,120,1400000US17075950900,"Census Tract 9509,Iroquois County",17,075,950900,Illinois
1851,1379,1129,250,1400000US17077010100,"Census Tract 101,Jackson County",17,077,010100,Illinois
1852,1852,1577,275,1400000US17077010200,"Census Tract 102,Jackson County",17,077,010200,Illinois
1853,1298,1070,228,1400000US17077010300,"Census Tract 103,Jackson County",17,077,010300,Illinois
1854,2147,1957,190,1400000US17077010400,"Census Tract 104,Jackson County",17,077,010400,Illinois
1855,930,817,113,1400000US17077010601,"Census Tract 106,01,Jackson County",17,077,010601,Illinois
1856,1521,1387,134,1400000US17077010602,"Census Tract 106,02,Jackson County",17,077,010602,Illinois
1857,1794,1440,354,1400000US17077010700,"Census Tract 107,Jackson County",17,077,010700,Illinois
1858,1907,1628,279,1400000US17077010800,"Census Tract 108,Jackson County",17,077,010800,Illinois
1859,1062,920,142,1400000US17077010900,"Census Tract 109,Jackson County",17,077,010900,Illinois
1860,925,741,184,1400000US17077011001,"Census Tract 110,01,Jackson County",17,077,011001,Illinois
1861,2316,2020,296,1400000US17077011002,"Census Tract 110,02,Jackson County",17,077,011002,Illinois
1862,2254,1709,545,1400000US17077011100,"Census Tract 111,Jackson County",17,077,011100,Illinois
1863,3183,2266,917,1400000US17077011200,"Census Tract 112,Jackson County",17,077,011200,Illinois
1864,1949,1708,241,1400000US17077011400,"Census Tract 114,Jackson County",17,077,011400,Illinois
1865,1628,1392,236,1400000US17077011600,"Census Tract 116,Jackson County",17,077,011600,Illinois
1866,1023,840,183,1400000US17077011701,"Census Tract 117,01,Jackson County",17,077,011701,Illinois
1867,730,585,145,1400000US17077011702,"Census Tract 117,02,Jackson County",17,077,011702,Illinois
1868,1244,1092,152,1400000US17079977300,"Census Tract 9773,Jasper County",17,079,977300,Illinois
1869,1371,1283,88,1400000US17079977400,"Census Tract 9774,Jasper County",17,079,977400,Illinois
1870,1620,1370,250,1400000US17079977500,"Census Tract 9775,Jasper County",17,079,977500,Illinois
1871,1848,1634,214,1400000US17081050100,"Census Tract 501,Jefferson County",17,081,050100,Illinois
1872,1267,1140,127,1400000US17081050200,"Census Tract 502,Jefferson County",17,081,050200,Illinois
1873,1871,1704,167,1400000US17081050300,"Census Tract 503,Jefferson County",17,081,050300,Illinois
1874,1518,1394,124,1400000US17081050400,"Census Tract 504,Jefferson County",17,081,050400,Illinois
1875,1919,1793,126,1400000US17081050500,"Census Tract 505,Jefferson County",17,081,050500,Illinois
1876,1445,1240,205,1400000US17081050600,"Census Tract 506,Jefferson County",17,081,050600,Illinois
1877,1686,1484,202,1400000US17081050700,"Census Tract 507,Jefferson County",17,081,050700,Illinois
1878,1836,1733,103,1400000US17081050800,"Census Tract 508,Jefferson County",17,081,050800,Illinois
1879,1394,1129,265,1400000US17081050900,"Census Tract 509,Jefferson County",17,081,050900,Illinois
1880,733,526,207,1400000US17081051000,"Census Tract 510,Jefferson County",17,081,051000,Illinois
1881,1140,831,309,1400000US17081051100,"Census Tract 511,Jefferson County",17,081,051100,Illinois
1882,2077,1853,224,1400000US17083010100,"Census Tract 101,Jersey County",17,083,010100,Illinois
1883,1439,1149,290,1400000US17083010200,"Census Tract 102,Jersey County",17,083,010200,Illinois
1884,1549,1167,382,1400000US17083010300,"Census Tract 103,Jersey County",17,083,010300,Illinois
1885,2806,2379,427,1400000US17083010401,"Census Tract 104,01,Jersey County",17,083,010401,Illinois
1886,930,716,214,1400000US17083010402,"Census Tract 104,02,Jersey County",17,083,010402,Illinois
1887,1016,554,462,1400000US17083010500,"Census Tract 105,Jersey County",17,083,010500,Illinois
1888,1639,889,750,1400000US17085020101,"Census Tract 201,01,Jo Daviess County",17,085,020101,Illinois
1889,1165,1021,144,1400000US17085020102,"Census Tract 201,02,Jo Daviess County",17,085,020102,Illinois
1890,2187,2015,172,1400000US17085020200,"Census Tract 202,Jo Daviess County",17,085,020200,Illinois
1891,2772,2439,333,1400000US17085020300,"Census Tract 203,Jo Daviess County",17,085,020300,Illinois
1892,2409,938,1471,1400000US17085020401,"Census Tract 204,01,Jo Daviess County",17,085,020401,Illinois
1893,1753,1357,396,1400000US17085020402,"Census Tract 204,02,Jo Daviess County",17,085,020402,Illinois
1894,1500,1347,153,1400000US17085020500,"Census Tract 205,Jo Daviess County",17,085,020500,Illinois
1895,2504,1602,902,1400000US17087977600,"Census Tract 9776,Johnson County",17,087,977600,Illinois
1896,1423,1179,244,1400000US17087977700,"Census Tract 9777,Johnson County",17,087,977700,Illinois
1897,1577,1268,309,1400000US17087977800,"Census Tract 9778,Johnson County",17,087,977800,Illinois
1898,30,6,24,1400000US17087980000,"Census Tract 9800,Johnson County",17,087,980000,Illinois
1899,2444,2444,0,1400000US17089850101,"Census Tract 8501,01,Kane County",17,089,850101,Illinois
1900,2087,2072,15,1400000US17089850103,"Census Tract 8501,03,Kane County",17,089,850103,Illinois
1901,2612,2567,45,1400000US17089850105,"Census Tract 8501,05,Kane County",17,089,850105,Illinois
1902,2648,2537,111,1400000US17089850106,"Census Tract 8501,06,Kane County",17,089,850106,Illinois
1903,1136,1102,34,1400000US17089850201,"Census Tract 8502,01,Kane County",17,089,850201,Illinois
1904,1770,1715,55,1400000US17089850202,"Census Tract 8502,02,Kane County",17,089,850202,Illinois
1905,2129,2056,73,1400000US17089850301,"Census Tract 8503,01,Kane County",17,089,850301,Illinois
1906,1674,1529,145,1400000US17089850302,"Census Tract 8503,02,Kane County",17,089,850302,Illinois
1907,1183,1130,53,1400000US17089850400,"Census Tract 8504,Kane County",17,089,850400,Illinois
1908,1761,1741,20,1400000US17089850500,"Census Tract 8505,Kane County",17,089,850500,Illinois
1909,2966,2839,127,1400000US17089850600,"Census Tract 8506,Kane County",17,089,850600,Illinois
1910,877,840,37,1400000US17089850703,"Census Tract 8507,03,Kane County",17,089,850703,Illinois
1911,3374,3265,109,1400000US17089850704,"Census Tract 8507,04,Kane County",17,089,850704,Illinois
1912,2670,2537,133,1400000US17089850705,"Census Tract 8507,05,Kane County",17,089,850705,Illinois
1913,830,830,0,1400000US17089850706,"Census Tract 8507,06,Kane County",17,089,850706,Illinois
1914,3465,3220,245,1400000US17089850707,"Census Tract 8507,07,Kane County",17,089,850707,Illinois
1915,1441,1441,0,1400000US17089850708,"Census Tract 8507,08,Kane County",17,089,850708,Illinois
1916,1471,1471,0,1400000US17089850709,"Census Tract 8507,09,Kane County",17,089,850709,Illinois
1917,2184,2184,0,1400000US17089850710,"Census Tract 8507,10,Kane County",17,089,850710,Illinois
1918,1325,1325,0,1400000US17089850711,"Census Tract 8507,11,Kane County",17,089,850711,Illinois
1919,2262,2201,61,1400000US17089850800,"Census Tract 8508,Kane County",17,089,850800,Illinois
1920,2871,2696,175,1400000US17089851000,"Census Tract 8510,Kane County",17,089,851000,Illinois
1921,1374,1354,20,1400000US17089851101,"Census Tract 8511,01,Kane County",17,089,851101,Illinois
1922,1349,1349,0,1400000US17089851102,"Census Tract 8511,02,Kane County",17,089,851102,Illinois
1923,1276,1196,80,1400000US17089851301,"Census Tract 8513,01,Kane County",17,089,851301,Illinois
1924,895,842,53,1400000US17089851302,"Census Tract 8513,02,Kane County",17,089,851302,Illinois
1925,1961,1890,71,1400000US17089851400,"Census Tract 8514,Kane County",17,089,851400,Illinois
1926,374,359,15,1400000US17089851500,"Census Tract 8515,Kane County",17,089,851500,Illinois
1927,2386,2319,67,1400000US17089851600,"Census Tract 8516,Kane County",17,089,851600,Illinois
1928,2855,2745,110,1400000US17089851801,"Census Tract 8518,01,Kane County",17,089,851801,Illinois
1929,2694,2605,89,1400000US17089851904,"Census Tract 8519,04,Kane County",17,089,851904,Illinois
1930,3029,3029,0,1400000US17089851907,"Census Tract 8519,07,Kane County",17,089,851907,Illinois
1931,2054,2054,0,1400000US17089851908,"Census Tract 8519,08,Kane County",17,089,851908,Illinois
1932,1682,1584,98,1400000US17089851909,"Census Tract 8519,09,Kane County",17,089,851909,Illinois
1933,1572,1487,85,1400000US17089851910,"Census Tract 8519,10,Kane County",17,089,851910,Illinois
1934,1606,1606,0,1400000US17089851911,"Census Tract 8519,11,Kane County",17,089,851911,Illinois
1935,1225,1225,0,1400000US17089851912,"Census Tract 8519,12,Kane County",17,089,851912,Illinois
1936,2091,2091,0,1400000US17089851913,"Census Tract 8519,13,Kane County",17,089,851913,Illinois
1937,1923,1790,133,1400000US17089852001,"Census Tract 8520,01,Kane County",17,089,852001,Illinois
1938,2961,2891,70,1400000US17089852002,"Census Tract 8520,02,Kane County",17,089,852002,Illinois
1939,1022,979,43,1400000US17089852004,"Census Tract 8520,04,Kane County",17,089,852004,Illinois
1940,1878,1878,0,1400000US17089852005,"Census Tract 8520,05,Kane County",17,089,852005,Illinois
1941,2499,2361,138,1400000US17089852101,"Census Tract 8521,01,Kane County",17,089,852101,Illinois
1942,2359,2298,61,1400000US17089852103,"Census Tract 8521,03,Kane County",17,089,852103,Illinois
1943,944,927,17,1400000US17089852104,"Census Tract 8521,04,Kane County",17,089,852104,Illinois
1944,2029,2025,4,1400000US17089852201,"Census Tract 8522,01,Kane County",17,089,852201,Illinois
1945,2123,1809,314,1400000US17089852203,"Census Tract 8522,03,Kane County",17,089,852203,Illinois
1946,1352,1281,71,1400000US17089852204,"Census Tract 8522,04,Kane County",17,089,852204,Illinois
1947,1126,1091,35,1400000US17089852300,"Census Tract 8523,Kane County",17,089,852300,Illinois
1948,2151,1997,154,1400000US17089852403,"Census Tract 8524,03,Kane County",17,089,852403,Illinois
1949,927,927,0,1400000US17089852404,"Census Tract 8524,04,Kane County",17,089,852404,Illinois
1950,1326,1266,60,1400000US17089852405,"Census Tract 8524,05,Kane County",17,089,852405,Illinois
1951,903,890,13,1400000US17089852406,"Census Tract 8524,06,Kane County",17,089,852406,Illinois
1952,1146,1146,0,1400000US17089852407,"Census Tract 8524,07,Kane County",17,089,852407,Illinois
1953,1641,1641,0,1400000US17089852408,"Census Tract 8524,08,Kane County",17,089,852408,Illinois
1954,2626,2513,113,1400000US17089852500,"Census Tract 8525,Kane County",17,089,852500,Illinois
1955,1875,1733,142,1400000US17089852606,"Census Tract 8526,06,Kane County",17,089,852606,Illinois
1956,1434,1389,45,1400000US17089852607,"Census Tract 8526,07,Kane County",17,089,852607,Illinois
1957,1611,1572,39,1400000US17089852608,"Census Tract 8526,08,Kane County",17,089,852608,Illinois
1958,3023,2898,125,1400000US17089852700,"Census Tract 8527,Kane County",17,089,852700,Illinois
1959,1705,1633,72,1400000US17089852803,"Census Tract 8528,03,Kane County",17,089,852803,Illinois
1960,2069,2019,50,1400000US17089852805,"Census Tract 8528,05,Kane County",17,089,852805,Illinois
1961,2401,2401,0,1400000US17089852806,"Census Tract 8528,06,Kane County",17,089,852806,Illinois
1962,1467,1451,16,1400000US17089852807,"Census Tract 8528,07,Kane County",17,089,852807,Illinois
1963,2661,2632,29,1400000US17089852808,"Census Tract 8528,08,Kane County",17,089,852808,Illinois
1964,2585,2442,143,1400000US17089852903,"Census Tract 8529,03,Kane County",17,089,852903,Illinois
1965,717,684,33,1400000US17089852904,"Census Tract 8529,04,Kane County",17,089,852904,Illinois
1966,1494,1377,117,1400000US17089852905,"Census Tract 8529,05,Kane County",17,089,852905,Illinois
1967,2154,2084,70,1400000US17089852906,"Census Tract 8529,06,Kane County",17,089,852906,Illinois
1968,1887,1805,82,1400000US17089852907,"Census Tract 8529,07,Kane County",17,089,852907,Illinois
1969,1447,1397,50,1400000US17089853001,"Census Tract 8530,01,Kane County",17,089,853001,Illinois
1970,1461,1394,67,1400000US17089853004,"Census Tract 8530,04,Kane County",17,089,853004,Illinois
1971,2039,2026,13,1400000US17089853005,"Census Tract 8530,05,Kane County",17,089,853005,Illinois
1972,1208,1185,23,1400000US17089853006,"Census Tract 8530,06,Kane County",17,089,853006,Illinois
1973,1666,1622,44,1400000US17089853007,"Census Tract 8530,07,Kane County",17,089,853007,Illinois
1974,1226,1207,19,1400000US17089853008,"Census Tract 8530,08,Kane County",17,089,853008,Illinois
1975,920,920,0,1400000US17089853100,"Census Tract 8531,Kane County",17,089,853100,Illinois
1976,1939,1828,111,1400000US17089853200,"Census Tract 8532,Kane County",17,089,853200,Illinois
1977,1338,1218,120,1400000US17089853300,"Census Tract 8533,Kane County",17,089,853300,Illinois
1978,668,623,45,1400000US17089853401,"Census Tract 8534,01,Kane County",17,089,853401,Illinois
1979,1472,1342,130,1400000US17089853402,"Census Tract 8534,02,Kane County",17,089,853402,Illinois
1980,1482,1404,78,1400000US17089853500,"Census Tract 8535,Kane County",17,089,853500,Illinois
1981,877,753,124,1400000US17089853601,"Census Tract 8536,01,Kane County",17,089,853601,Illinois
1982,1210,1174,36,1400000US17089853602,"Census Tract 8536,02,Kane County",17,089,853602,Illinois
1983,2101,2062,39,1400000US17089853900,"Census Tract 8539,Kane County",17,089,853900,Illinois
1984,1581,1550,31,1400000US17089854001,"Census Tract 8540,01,Kane County",17,089,854001,Illinois
1985,2265,2120,145,1400000US17089854002,"Census Tract 8540,02,Kane County",17,089,854002,Illinois
1986,1273,1215,58,1400000US17089854100,"Census Tract 8541,Kane County",17,089,854100,Illinois
1987,1450,1412,38,1400000US17089854200,"Census Tract 8542,Kane County",17,089,854200,Illinois
1988,1670,1622,48,1400000US17089854301,"Census Tract 8543,01,Kane County",17,089,854301,Illinois
1989,1406,1383,23,1400000US17089854302,"Census Tract 8543,02,Kane County",17,089,854302,Illinois
1990,863,725,138,1400000US17089854401,"Census Tract 8544,01,Kane County",17,089,854401,Illinois
1991,1187,1074,113,1400000US17089854402,"Census Tract 8544,02,Kane County",17,089,854402,Illinois
1992,2474,2386,88,1400000US17089854403,"Census Tract 8544,03,Kane County",17,089,854403,Illinois
1993,3186,3140,46,1400000US17089854504,"Census Tract 8545,04,Kane County",17,089,854504,Illinois
1994,2584,2569,15,1400000US17089854505,"Census Tract 8545,05,Kane County",17,089,854505,Illinois
1995,1151,1151,0,1400000US17089854506,"Census Tract 8545,06,Kane County",17,089,854506,Illinois
1996,2242,2061,181,1400000US17089854507,"Census Tract 8545,07,Kane County",17,089,854507,Illinois
1997,2043,2043,0,1400000US17089854508,"Census Tract 8545,08,Kane County",17,089,854508,Illinois
1998,2354,2287,67,1400000US17089854509,"Census Tract 8545,09,Kane County",17,089,854509,Illinois
1999,1602,1527,75,1400000US17089854600,"Census Tract 8546,Kane County",17,089,854600,Illinois
2000,906,806,100,1400000US17089854700,"Census Tract 8547,Kane County",17,089,854700,Illinois
2001,2801,2721,80,1400000US17089854800,"Census Tract 8548,Kane County",17,089,854800,Illinois
2002,2138,2009,129,1400000US17089854900,"Census Tract 8549,Kane County",17,089,854900,Illinois
2003,896,842,54,1400000US17091010100,"Census Tract 101,Kankakee County",17,091,010100,Illinois
2004,836,823,13,1400000US17091010201,"Census Tract 102,01,Kankakee County",17,091,010201,Illinois
2005,1793,1748,45,1400000US17091010203,"Census Tract 102,03,Kankakee County",17,091,010203,Illinois
2006,2341,2148,193,1400000US17091010204,"Census Tract 102,04,Kankakee County",17,091,010204,Illinois
2007,1605,1502,103,1400000US17091010300,"Census Tract 103,Kankakee County",17,091,010300,Illinois
2008,1950,1854,96,1400000US17091010400,"Census Tract 104,Kankakee County",17,091,010400,Illinois
2009,2530,2255,275,1400000US17091010500,"Census Tract 105,Kankakee County",17,091,010500,Illinois
2010,1869,1747,122,1400000US17091010601,"Census Tract 106,01,Kankakee County",17,091,010601,Illinois
2011,2177,2076,101,1400000US17091010602,"Census Tract 106,02,Kankakee County",17,091,010602,Illinois
2012,1755,1591,164,1400000US17091010701,"Census Tract 107,01,Kankakee County",17,091,010701,Illinois
2013,2876,2644,232,1400000US17091010702,"Census Tract 107,02,Kankakee County",17,091,010702,Illinois
2014,1374,1249,125,1400000US17091010800,"Census Tract 108,Kankakee County",17,091,010800,Illinois
2015,1989,1747,242,1400000US17091010900,"Census Tract 109,Kankakee County",17,091,010900,Illinois
2016,1080,646,434,1400000US17091011000,"Census Tract 110,Kankakee County",17,091,011000,Illinois
2017,900,819,81,1400000US17091011100,"Census Tract 111,Kankakee County",17,091,011100,Illinois
2018,828,757,71,1400000US17091011200,"Census Tract 112,Kankakee County",17,091,011200,Illinois
2019,1028,927,101,1400000US17091011300,"Census Tract 113,Kankakee County",17,091,011300,Illinois
2020,863,736,127,1400000US17091011400,"Census Tract 114,Kankakee County",17,091,011400,Illinois
2021,953,734,219,1400000US17091011500,"Census Tract 115,Kankakee County",17,091,011500,Illinois
2022,878,561,317,1400000US17091011600,"Census Tract 116,Kankakee County",17,091,011600,Illinois
2023,1496,1230,266,1400000US17091011700,"Census Tract 117,Kankakee County",17,091,011700,Illinois
2024,1189,1068,121,1400000US17091011800,"Census Tract 118,Kankakee County",17,091,011800,Illinois
2025,671,634,37,1400000US17091011900,"Census Tract 119,Kankakee County",17,091,011900,Illinois
2026,1739,1532,207,1400000US17091012000,"Census Tract 120,Kankakee County",17,091,012000,Illinois
2027,1769,1534,235,1400000US17091012100,"Census Tract 121,Kankakee County",17,091,012100,Illinois
2028,1501,1308,193,1400000US17091012200,"Census Tract 122,Kankakee County",17,091,012200,Illinois
2029,1816,1341,475,1400000US17091012300,"Census Tract 123,Kankakee County",17,091,012300,Illinois
2030,2027,1948,79,1400000US17091012400,"Census Tract 124,Kankakee County",17,091,012400,Illinois
2031,768,677,91,1400000US17091012500,"Census Tract 125,Kankakee County",17,091,012500,Illinois
2032,1791,1668,123,1400000US17091012600,"Census Tract 126,Kankakee County",17,091,012600,Illinois
2033,2219,2219,0,1400000US17093890103,"Census Tract 8901,03,Kendall County",17,093,890103,Illinois
2034,2161,2161,0,1400000US17093890104,"Census Tract 8901,04,Kendall County",17,093,890104,Illinois
2035,2696,2652,44,1400000US17093890105,"Census Tract 8901,05,Kendall County",17,093,890105,Illinois
2036,1650,1650,0,1400000US17093890106,"Census Tract 8901,06,Kendall County",17,093,890106,Illinois
2037,1447,1373,74,1400000US17093890107,"Census Tract 8901,07,Kendall County",17,093,890107,Illinois
2038,1726,1726,0,1400000US17093890108,"Census Tract 8901,08,Kendall County",17,093,890108,Illinois
2039,1673,1645,28,1400000US17093890201,"Census Tract 8902,01,Kendall County",17,093,890201,Illinois
2040,1229,1214,15,1400000US17093890202,"Census Tract 8902,02,Kendall County",17,093,890202,Illinois
2041,2417,2377,40,1400000US17093890301,"Census Tract 8903,01,Kendall County",17,093,890301,Illinois
2042,2227,2202,25,1400000US17093890302,"Census Tract 8903,02,Kendall County",17,093,890302,Illinois
2043,2291,2291,0,1400000US17093890401,"Census Tract 8904,01,Kendall County",17,093,890401,Illinois
2044,3418,3238,180,1400000US17093890402,"Census Tract 8904,02,Kendall County",17,093,890402,Illinois
2045,1621,1621,0,1400000US17093890403,"Census Tract 8904,03,Kendall County",17,093,890403,Illinois
2046,3033,2897,136,1400000US17093890404,"Census Tract 8904,04,Kendall County",17,093,890404,Illinois
2047,3150,3098,52,1400000US17093890501,"Census Tract 8905,01,Kendall County",17,093,890501,Illinois
2048,1969,1745,224,1400000US17093890502,"Census Tract 8905,02,Kendall County",17,093,890502,Illinois
2049,1633,1589,44,1400000US17093890601,"Census Tract 8906,01,Kendall County",17,093,890601,Illinois
2050,2052,1811,241,1400000US17093890602,"Census Tract 8906,02,Kendall County",17,093,890602,Illinois
2051,1715,1715,0,1400000US17093890701,"Census Tract 8907,01,Kendall County",17,093,890701,Illinois
2052,1482,1437,45,1400000US17093890702,"Census Tract 8907,02,Kendall County",17,093,890702,Illinois
2053,2634,2564,70,1400000US17093890703,"Census Tract 8907,03,Kendall County",17,093,890703,Illinois
2054,1343,1141,202,1400000US17095000100,"Census Tract 1,Knox County",17,095,000100,Illinois
2055,1657,1223,434,1400000US17095000200,"Census Tract 2,Knox County",17,095,000200,Illinois
2056,2287,2094,193,1400000US17095000300,"Census Tract 3,Knox County",17,095,000300,Illinois
2057,2354,2134,220,1400000US17095000400,"Census Tract 4,Knox County",17,095,000400,Illinois
2058,1752,1598,154,1400000US17095000500,"Census Tract 5,Knox County",17,095,000500,Illinois
2059,1784,1579,205,1400000US17095000600,"Census Tract 6,Knox County",17,095,000600,Illinois
2060,928,792,136,1400000US17095000700,"Census Tract 7,Knox County",17,095,000700,Illinois
2061,1152,953,199,1400000US17095000800,"Census Tract 8,Knox County",17,095,000800,Illinois
2062,1208,875,333,1400000US17095000900,"Census Tract 9,Knox County",17,095,000900,Illinois
2063,1925,1635,290,1400000US17095001000,"Census Tract 10,Knox County",17,095,001000,Illinois
2064,1187,959,228,1400000US17095001100,"Census Tract 11,Knox County",17,095,001100,Illinois
2065,694,612,82,1400000US17095001200,"Census Tract 12,Knox County",17,095,001200,Illinois
2066,1563,1467,96,1400000US17095001300,"Census Tract 13,Knox County",17,095,001300,Illinois
2067,841,691,150,1400000US17095001400,"Census Tract 14,Knox County",17,095,001400,Illinois
2068,1790,1629,161,1400000US17095001500,"Census Tract 15,Knox County",17,095,001500,Illinois
2069,1374,1193,181,1400000US17095001600,"Census Tract 16,Knox County",17,095,001600,Illinois
2070,1500,1445,55,1400000US17097860103,"Census Tract 8601,03,Lake County",17,097,860103,Illinois
2071,1496,1359,137,1400000US17097860104,"Census Tract 8601,04,Lake County",17,097,860104,Illinois
2072,1783,1630,153,1400000US17097860105,"Census Tract 8601,05,Lake County",17,097,860105,Illinois
2073,1250,1121,129,1400000US17097860106,"Census Tract 8601,06,Lake County",17,097,860106,Illinois
2074,1338,1318,20,1400000US17097860200,"Census Tract 8602,Lake County",17,097,860200,Illinois
2075,1317,1147,170,1400000US17097860301,"Census Tract 8603,01,Lake County",17,097,860301,Illinois
2076,1206,1017,189,1400000US17097860302,"Census Tract 8603,02,Lake County",17,097,860302,Illinois
2077,2446,2335,111,1400000US17097860400,"Census Tract 8604,Lake County",17,097,860400,Illinois
2078,1808,1638,170,1400000US17097860500,"Census Tract 8605,Lake County",17,097,860500,Illinois
2079,3030,2914,116,1400000US17097860600,"Census Tract 8606,Lake County",17,097,860600,Illinois
2080,873,753,120,1400000US17097860805,"Census Tract 8608,05,Lake County",17,097,860805,Illinois
2081,2057,1878,179,1400000US17097860806,"Census Tract 8608,06,Lake County",17,097,860806,Illinois
2082,2046,1825,221,1400000US17097860807,"Census Tract 8608,07,Lake County",17,097,860807,Illinois
2083,1751,1151,600,1400000US17097860808,"Census Tract 8608,08,Lake County",17,097,860808,Illinois
2084,1359,1275,84,1400000US17097860809,"Census Tract 8608,09,Lake County",17,097,860809,Illinois
2085,2002,1821,181,1400000US17097860811,"Census Tract 8608,11,Lake County",17,097,860811,Illinois
2086,1306,1193,113,1400000US17097860812,"Census Tract 8608,12,Lake County",17,097,860812,Illinois
2087,1396,1349,47,1400000US17097860813,"Census Tract 8608,13,Lake County",17,097,860813,Illinois
2088,2935,2778,157,1400000US17097860903,"Census Tract 8609,03,Lake County",17,097,860903,Illinois
2089,2090,1732,358,1400000US17097860905,"Census Tract 8609,05,Lake County",17,097,860905,Illinois
2090,3864,3791,73,1400000US17097860906,"Census Tract 8609,06,Lake County",17,097,860906,Illinois
2091,1287,1189,98,1400000US17097860907,"Census Tract 8609,07,Lake County",17,097,860907,Illinois
2092,1192,835,357,1400000US17097860908,"Census Tract 8609,08,Lake County",17,097,860908,Illinois
2093,1359,1271,88,1400000US17097861007,"Census Tract 8610,07,Lake County",17,097,861007,Illinois
2094,2041,1872,169,1400000US17097861008,"Census Tract 8610,08,Lake County",17,097,861008,Illinois
2095,1826,1757,69,1400000US17097861009,"Census Tract 8610,09,Lake County",17,097,861009,Illinois
2096,1907,1823,84,1400000US17097861010,"Census Tract 8610,10,Lake County",17,097,861010,Illinois
2097,2572,2523,49,1400000US17097861011,"Census Tract 8610,11,Lake County",17,097,861011,Illinois
2098,2029,1916,113,1400000US17097861012,"Census Tract 8610,12,Lake County",17,097,861012,Illinois
2099,1320,1294,26,1400000US17097861013,"Census Tract 8610,13,Lake County",17,097,861013,Illinois
2100,1181,1141,40,1400000US17097861014,"Census Tract 8610,14,Lake County",17,097,861014,Illinois
2101,1906,1883,23,1400000US17097861105,"Census Tract 8611,05,Lake County",17,097,861105,Illinois
2102,2789,2746,43,1400000US17097861106,"Census Tract 8611,06,Lake County",17,097,861106,Illinois
2103,1421,1347,74,1400000US17097861107,"Census Tract 8611,07,Lake County",17,097,861107,Illinois
2104,2246,2146,100,1400000US17097861108,"Census Tract 8611,08,Lake County",17,097,861108,Illinois
2105,2002,1810,192,1400000US17097861201,"Census Tract 8612,01,Lake County",17,097,861201,Illinois
2106,1383,1335,48,1400000US17097861202,"Census Tract 8612,02,Lake County",17,097,861202,Illinois
2107,2186,2065,121,1400000US17097861301,"Census Tract 8613,01,Lake County",17,097,861301,Illinois
2108,1358,1330,28,1400000US17097861303,"Census Tract 8613,03,Lake County",17,097,861303,Illinois
2109,891,849,42,1400000US17097861304,"Census Tract 8613,04,Lake County",17,097,861304,Illinois
2110,3285,3200,85,1400000US17097861402,"Census Tract 8614,02,Lake County",17,097,861402,Illinois
2111,792,711,81,1400000US17097861403,"Census Tract 8614,03,Lake County",17,097,861403,Illinois
2112,1955,1908,47,1400000US17097861404,"Census Tract 8614,04,Lake County",17,097,861404,Illinois
2113,3067,2987,80,1400000US17097861504,"Census Tract 8615,04,Lake County",17,097,861504,Illinois
2114,1273,1235,38,1400000US17097861505,"Census Tract 8615,05,Lake County",17,097,861505,Illinois
2115,2287,2215,72,1400000US17097861506,"Census Tract 8615,06,Lake County",17,097,861506,Illinois
2116,965,909,56,1400000US17097861507,"Census Tract 8615,07,Lake County",17,097,861507,Illinois
2117,1685,1608,77,1400000US17097861508,"Census Tract 8615,08,Lake County",17,097,861508,Illinois
2118,1459,1450,9,1400000US17097861509,"Census Tract 8615,09,Lake County",17,097,861509,Illinois
2119,1746,1690,56,1400000US17097861510,"Census Tract 8615,10,Lake County",17,097,861510,Illinois
2120,2876,2685,191,1400000US17097861603,"Census Tract 8616,03,Lake County",17,097,861603,Illinois
2121,2171,2058,113,1400000US17097861604,"Census Tract 8616,04,Lake County",17,097,861604,Illinois
2122,2025,1732,293,1400000US17097861607,"Census Tract 8616,07,Lake County",17,097,861607,Illinois
2123,1324,1269,55,1400000US17097861608,"Census Tract 8616,08,Lake County",17,097,861608,Illinois
2124,1683,1646,37,1400000US17097861609,"Census Tract 8616,09,Lake County",17,097,861609,Illinois
2125,1313,1276,37,1400000US17097861610,"Census Tract 8616,10,Lake County",17,097,861610,Illinois
2126,1257,1231,26,1400000US17097861611,"Census Tract 8616,11,Lake County",17,097,861611,Illinois
2127,562,555,7,1400000US17097861701,"Census Tract 8617,01,Lake County",17,097,861701,Illinois
2128,1532,1387,145,1400000US17097861702,"Census Tract 8617,02,Lake County",17,097,861702,Illinois
2129,2536,2448,88,1400000US17097861803,"Census Tract 8618,03,Lake County",17,097,861803,Illinois
2130,1314,1261,53,1400000US17097861804,"Census Tract 8618,04,Lake County",17,097,861804,Illinois
2131,1036,1036,0,1400000US17097861901,"Census Tract 8619,01,Lake County",17,097,861901,Illinois
2132,2954,2918,36,1400000US17097861902,"Census Tract 8619,02,Lake County",17,097,861902,Illinois
2133,2212,2014,198,1400000US17097862000,"Census Tract 8620,Lake County",17,097,862000,Illinois
2134,1931,1780,151,1400000US17097862100,"Census Tract 8621,Lake County",17,097,862100,Illinois
2135,1436,1222,214,1400000US17097862200,"Census Tract 8622,Lake County",17,097,862200,Illinois
2136,1164,1001,163,1400000US17097862300,"Census Tract 8623,Lake County",17,097,862300,Illinois
2137,1407,1263,144,1400000US17097862401,"Census Tract 8624,01,Lake County",17,097,862401,Illinois
2138,1125,1041,84,1400000US17097862402,"Census Tract 8624,02,Lake County",17,097,862402,Illinois
2139,1153,1125,28,1400000US17097862501,"Census Tract 8625,01,Lake County",17,097,862501,Illinois
2140,548,536,12,1400000US17097862502,"Census Tract 8625,02,Lake County",17,097,862502,Illinois
2141,2553,2553,0,1400000US17097862603,"Census Tract 8626,03,Lake County",17,097,862603,Illinois
2142,1455,1411,44,1400000US17097862604,"Census Tract 8626,04,Lake County",17,097,862604,Illinois
2143,1708,1572,136,1400000US17097862605,"Census Tract 8626,05,Lake County",17,097,862605,Illinois
2144,1229,1126,103,1400000US17097862700,"Census Tract 8627,Lake County",17,097,862700,Illinois
2145,841,715,126,1400000US17097862800,"Census Tract 8628,Lake County",17,097,862800,Illinois
2146,1271,1161,110,1400000US17097862901,"Census Tract 8629,01,Lake County",17,097,862901,Illinois
2147,1193,903,290,1400000US17097862902,"Census Tract 8629,02,Lake County",17,097,862902,Illinois
2148,25,25,0,1400000US17097863003,"Census Tract 8630,03,Lake County",17,097,863003,Illinois
2149,2179,1961,218,1400000US17097863004,"Census Tract 8630,04,Lake County",17,097,863004,Illinois
2150,0,0,0,1400000US17097863005,"Census Tract 8630,05,Lake County",17,097,863005,Illinois
2151,0,0,0,1400000US17097863006,"Census Tract 8630,06,Lake County",17,097,863006,Illinois
2152,1027,925,102,1400000US17097863100,"Census Tract 8631,Lake County",17,097,863100,Illinois
2153,1156,1038,118,1400000US17097863201,"Census Tract 8632,01,Lake County",17,097,863201,Illinois
2154,2123,2067,56,1400000US17097863202,"Census Tract 8632,02,Lake County",17,097,863202,Illinois
2155,1015,921,94,1400000US17097863300,"Census Tract 8633,Lake County",17,097,863300,Illinois
2156,1529,1323,206,1400000US17097863400,"Census Tract 8634,Lake County",17,097,863400,Illinois
2157,2310,2086,224,1400000US17097863500,"Census Tract 8635,Lake County",17,097,863500,Illinois
2158,1205,1180,25,1400000US17097863601,"Census Tract 8636,01,Lake County",17,097,863601,Illinois
2159,1147,1132,15,1400000US17097863603,"Census Tract 8636,03,Lake County",17,097,863603,Illinois
2160,1134,1079,55,1400000US17097863604,"Census Tract 8636,04,Lake County",17,097,863604,Illinois
2161,1986,1952,34,1400000US17097863701,"Census Tract 8637,01,Lake County",17,097,863701,Illinois
2162,2051,1950,101,1400000US17097863702,"Census Tract 8637,02,Lake County",17,097,863702,Illinois
2163,1945,1763,182,1400000US17097863801,"Census Tract 8638,01,Lake County",17,097,863801,Illinois
2164,3235,2828,407,1400000US17097863902,"Census Tract 8639,02,Lake County",17,097,863902,Illinois
2165,1603,1579,24,1400000US17097863903,"Census Tract 8639,03,Lake County",17,097,863903,Illinois
2166,2188,2112,76,1400000US17097863904,"Census Tract 8639,04,Lake County",17,097,863904,Illinois
2167,2284,2165,119,1400000US17097864001,"Census Tract 8640,01,Lake County",17,097,864001,Illinois
2168,1762,1528,234,1400000US17097864002,"Census Tract 8640,02,Lake County",17,097,864002,Illinois
2169,2542,2467,75,1400000US17097864105,"Census Tract 8641,05,Lake County",17,097,864105,Illinois
2170,1426,1384,42,1400000US17097864106,"Census Tract 8641,06,Lake County",17,097,864106,Illinois
2171,1883,1875,8,1400000US17097864107,"Census Tract 8641,07,Lake County",17,097,864107,Illinois
2172,2071,2038,33,1400000US17097864108,"Census Tract 8641,08,Lake County",17,097,864108,Illinois
2173,2108,1927,181,1400000US17097864109,"Census Tract 8641,09,Lake County",17,097,864109,Illinois
2174,2961,2798,163,1400000US17097864110,"Census Tract 8641,10,Lake County",17,097,864110,Illinois
2175,1672,1546,126,1400000US17097864203,"Census Tract 8642,03,Lake County",17,097,864203,Illinois
2176,1789,1608,181,1400000US17097864204,"Census Tract 8642,04,Lake County",17,097,864204,Illinois
2177,1462,1347,115,1400000US17097864206,"Census Tract 8642,06,Lake County",17,097,864206,Illinois
2178,2515,2351,164,1400000US17097864207,"Census Tract 8642,07,Lake County",17,097,864207,Illinois
2179,1808,1779,29,1400000US17097864208,"Census Tract 8642,08,Lake County",17,097,864208,Illinois
2180,1619,1550,69,1400000US17097864303,"Census Tract 8643,03,Lake County",17,097,864303,Illinois
2181,1963,1879,84,1400000US17097864305,"Census Tract 8643,05,Lake County",17,097,864305,Illinois
2182,749,716,33,1400000US17097864306,"Census Tract 8643,06,Lake County",17,097,864306,Illinois
2183,935,841,94,1400000US17097864307,"Census Tract 8643,07,Lake County",17,097,864307,Illinois
2184,1872,1699,173,1400000US17097864308,"Census Tract 8643,08,Lake County",17,097,864308,Illinois
2185,2706,2580,126,1400000US17097864402,"Census Tract 8644,02,Lake County",17,097,864402,Illinois
2186,2065,1828,237,1400000US17097864403,"Census Tract 8644,03,Lake County",17,097,864403,Illinois
2187,2074,1961,113,1400000US17097864407,"Census Tract 8644,07,Lake County",17,097,864407,Illinois
2188,2690,2486,204,1400000US17097864408,"Census Tract 8644,08,Lake County",17,097,864408,Illinois
2189,1770,1712,58,1400000US17097864409,"Census Tract 8644,09,Lake County",17,097,864409,Illinois
2190,1720,1696,24,1400000US17097864410,"Census Tract 8644,10,Lake County",17,097,864410,Illinois
2191,1678,1656,22,1400000US17097864411,"Census Tract 8644,11,Lake County",17,097,864411,Illinois
2192,1385,1340,45,1400000US17097864412,"Census Tract 8644,12,Lake County",17,097,864412,Illinois
2193,2030,1992,38,1400000US17097864510,"Census Tract 8645,10,Lake County",17,097,864510,Illinois
2194,2554,2358,196,1400000US17097864511,"Census Tract 8645,11,Lake County",17,097,864511,Illinois
2195,1421,1402,19,1400000US17097864512,"Census Tract 8645,12,Lake County",17,097,864512,Illinois
2196,2215,2140,75,1400000US17097864513,"Census Tract 8645,13,Lake County",17,097,864513,Illinois
2197,1059,1041,18,1400000US17097864514,"Census Tract 8645,14,Lake County",17,097,864514,Illinois
2198,1003,957,46,1400000US17097864515,"Census Tract 8645,15,Lake County",17,097,864515,Illinois
2199,1675,1549,126,1400000US17097864516,"Census Tract 8645,16,Lake County",17,097,864516,Illinois
2200,1086,1086,0,1400000US17097864517,"Census Tract 8645,17,Lake County",17,097,864517,Illinois
2201,1860,1824,36,1400000US17097864518,"Census Tract 8645,18,Lake County",17,097,864518,Illinois
2202,1889,1802,87,1400000US17097864519,"Census Tract 8645,19,Lake County",17,097,864519,Illinois
2203,1730,1680,50,1400000US17097864520,"Census Tract 8645,20,Lake County",17,097,864520,Illinois
2204,1560,1448,112,1400000US17097864521,"Census Tract 8645,21,Lake County",17,097,864521,Illinois
2205,1605,1605,0,1400000US17097864522,"Census Tract 8645,22,Lake County",17,097,864522,Illinois
2206,1632,1580,52,1400000US17097864523,"Census Tract 8645,23,Lake County",17,097,864523,Illinois
2207,1657,1544,113,1400000US17097864524,"Census Tract 8645,24,Lake County",17,097,864524,Illinois
2208,1324,1215,109,1400000US17097864601,"Census Tract 8646,01,Lake County",17,097,864601,Illinois
2209,1281,1261,20,1400000US17097864602,"Census Tract 8646,02,Lake County",17,097,864602,Illinois
2210,1058,985,73,1400000US17097864700,"Census Tract 8647,Lake County",17,097,864700,Illinois
2211,1742,1707,35,1400000US17097864801,"Census Tract 8648,01,Lake County",17,097,864801,Illinois
2212,1165,1074,91,1400000US17097864802,"Census Tract 8648,02,Lake County",17,097,864802,Illinois
2213,1610,1589,21,1400000US17097864901,"Census Tract 8649,01,Lake County",17,097,864901,Illinois
2214,1827,1812,15,1400000US17097864903,"Census Tract 8649,03,Lake County",17,097,864903,Illinois
2215,1232,1232,0,1400000US17097864904,"Census Tract 8649,04,Lake County",17,097,864904,Illinois
2216,409,376,33,1400000US17097865000,"Census Tract 8650,Lake County",17,097,865000,Illinois
2217,2225,2108,117,1400000US17097865200,"Census Tract 8652,Lake County",17,097,865200,Illinois
2218,1204,1183,21,1400000US17097865300,"Census Tract 8653,Lake County",17,097,865300,Illinois
2219,2373,2199,174,1400000US17097865400,"Census Tract 8654,Lake County",17,097,865400,Illinois
2220,1145,1078,67,1400000US17097865501,"Census Tract 8655,01,Lake County",17,097,865501,Illinois
2221,933,830,103,1400000US17097865502,"Census Tract 8655,02,Lake County",17,097,865502,Illinois
2222,1434,1420,14,1400000US17097865600,"Census Tract 8656,Lake County",17,097,865600,Illinois
2223,2384,2365,19,1400000US17097865700,"Census Tract 8657,Lake County",17,097,865700,Illinois
2224,1331,1317,14,1400000US17097865801,"Census Tract 8658,01,Lake County",17,097,865801,Illinois
2225,1018,1000,18,1400000US17097865802,"Census Tract 8658,02,Lake County",17,097,865802,Illinois
2226,2475,2395,80,1400000US17097866000,"Census Tract 8660,Lake County",17,097,866000,Illinois
2227,1252,1129,123,1400000US17097866100,"Census Tract 8661,Lake County",17,097,866100,Illinois
2228,2671,2330,341,1400000US17097866200,"Census Tract 8662,Lake County",17,097,866200,Illinois
2229,0,0,0,1400000US17097990000,"Census Tract 9900,Lake County",17,097,990000,Illinois
2230,2582,2325,257,1400000US17099961701,"Census Tract 9617,01,LaSalle County",17,099,961701,Illinois
2231,1301,1263,38,1400000US17099961702,"Census Tract 9617,02,LaSalle County",17,099,961702,Illinois
2232,1681,1558,123,1400000US17099961800,"Census Tract 9618,LaSalle County",17,099,961800,Illinois
2233,2088,1829,259,1400000US17099961900,"Census Tract 9619,LaSalle County",17,099,961900,Illinois
2234,1416,1323,93,1400000US17099962000,"Census Tract 9620,LaSalle County",17,099,962000,Illinois
2235,2146,2075,71,1400000US17099962100,"Census Tract 9621,LaSalle County",17,099,962100,Illinois
2236,2109,1927,182,1400000US17099962200,"Census Tract 9622,LaSalle County",17,099,962200,Illinois
2237,2697,2291,406,1400000US17099962300,"Census Tract 9623,LaSalle County",17,099,962300,Illinois
2238,1891,1493,398,1400000US17099962400,"Census Tract 9624,LaSalle County",17,099,962400,Illinois
2239,872,809,63,1400000US17099962500,"Census Tract 9625,LaSalle County",17,099,962500,Illinois
2240,2385,2157,228,1400000US17099962600,"Census Tract 9626,LaSalle County",17,099,962600,Illinois
2241,1209,1100,109,1400000US17099962700,"Census Tract 9627,LaSalle County",17,099,962700,Illinois
2242,1727,1512,215,1400000US17099962800,"Census Tract 9628,LaSalle County",17,099,962800,Illinois
2243,1577,1371,206,1400000US17099962900,"Census Tract 9629,LaSalle County",17,099,962900,Illinois
2244,2291,2116,175,1400000US17099963000,"Census Tract 9630,LaSalle County",17,099,963000,Illinois
2245,1604,1442,162,1400000US17099963100,"Census Tract 9631,LaSalle County",17,099,963100,Illinois
2246,1395,1128,267,1400000US17099963200,"Census Tract 9632,LaSalle County",17,099,963200,Illinois
2247,1303,1144,159,1400000US17099963300,"Census Tract 9633,LaSalle County",17,099,963300,Illinois
2248,1858,1670,188,1400000US17099963400,"Census Tract 9634,LaSalle County",17,099,963400,Illinois
2249,2080,1945,135,1400000US17099963500,"Census Tract 9635,LaSalle County",17,099,963500,Illinois
2250,1431,1295,136,1400000US17099963600,"Census Tract 9636,LaSalle County",17,099,963600,Illinois
2251,2170,1980,190,1400000US17099963700,"Census Tract 9637,LaSalle County",17,099,963700,Illinois
2252,2029,1817,212,1400000US17099963800,"Census Tract 9638,LaSalle County",17,099,963800,Illinois
2253,2543,2452,91,1400000US17099963900,"Census Tract 9639,LaSalle County",17,099,963900,Illinois
2254,1096,1002,94,1400000US17099964000,"Census Tract 9640,LaSalle County",17,099,964000,Illinois
2255,1789,1554,235,1400000US17099964100,"Census Tract 9641,LaSalle County",17,099,964100,Illinois
2256,1167,1079,88,1400000US17099964200,"Census Tract 9642,LaSalle County",17,099,964200,Illinois
2257,1388,1216,172,1400000US17099964300,"Census Tract 9643,LaSalle County",17,099,964300,Illinois
2258,1405,1168,237,1400000US17101880700,"Census Tract 8807,Lawrence County",17,101,880700,Illinois
2259,1489,1308,181,1400000US17101880800,"Census Tract 8808,Lawrence County",17,101,880800,Illinois
2260,1078,951,127,1400000US17101880900,"Census Tract 8809,Lawrence County",17,101,880900,Illinois
2261,857,755,102,1400000US17101881000,"Census Tract 8810,Lawrence County",17,101,881000,Illinois
2262,1532,1267,265,1400000US17101881100,"Census Tract 8811,Lawrence County",17,101,881100,Illinois
2263,1104,1014,90,1400000US17103000100,"Census Tract 1,Lee County",17,103,000100,Illinois
2264,1324,1196,128,1400000US17103000200,"Census Tract 2,Lee County",17,103,000200,Illinois
2265,1917,1748,169,1400000US17103000300,"Census Tract 3,Lee County",17,103,000300,Illinois
2266,2482,2274,208,1400000US17103000400,"Census Tract 4,Lee County",17,103,000400,Illinois
2267,2369,2241,128,1400000US17103000500,"Census Tract 5,Lee County",17,103,000500,Illinois
2268,1859,1628,231,1400000US17103000600,"Census Tract 6,Lee County",17,103,000600,Illinois
2269,857,665,192,1400000US17103000700,"Census Tract 7,Lee County",17,103,000700,Illinois
2270,1590,1441,149,1400000US17103000800,"Census Tract 8,Lee County",17,103,000800,Illinois
2271,1497,1301,196,1400000US17103000900,"Census Tract 9,Lee County",17,103,000900,Illinois
2272,1737,1513,224,1400000US17105960100,"Census Tract 9601,Livingston County",17,105,960100,Illinois
2273,1434,1274,160,1400000US17105960200,"Census Tract 9602,Livingston County",17,105,960200,Illinois
2274,1495,1348,147,1400000US17105960300,"Census Tract 9603,Livingston County",17,105,960300,Illinois
2275,1458,1246,212,1400000US17105960400,"Census Tract 9604,Livingston County",17,105,960400,Illinois
2276,1330,1232,98,1400000US17105960500,"Census Tract 9605,Livingston County",17,105,960500,Illinois
2277,2079,1876,203,1400000US17105960600,"Census Tract 9606,Livingston County",17,105,960600,Illinois
2278,1802,1687,115,1400000US17105960700,"Census Tract 9607,Livingston County",17,105,960700,Illinois
2279,2470,2329,141,1400000US17105960800,"Census Tract 9608,Livingston County",17,105,960800,Illinois
2280,982,911,71,1400000US17105960900,"Census Tract 9609,Livingston County",17,105,960900,Illinois
2281,1138,1015,123,1400000US17105961000,"Census Tract 9610,Livingston County",17,105,961000,Illinois
2282,1592,1500,92,1400000US17107952900,"Census Tract 9529,Logan County",17,107,952900,Illinois
2283,1113,987,126,1400000US17107953000,"Census Tract 9530,Logan County",17,107,953000,Illinois
2284,1663,1592,71,1400000US17107953100,"Census Tract 9531,Logan County",17,107,953100,Illinois
2285,1542,1408,134,1400000US17107953200,"Census Tract 9532,Logan County",17,107,953200,Illinois
2286,1710,1501,209,1400000US17107953300,"Census Tract 9533,Logan County",17,107,953300,Illinois
2287,1680,1615,65,1400000US17107953400,"Census Tract 9534,Logan County",17,107,953400,Illinois
2288,1238,1026,212,1400000US17107953500,"Census Tract 9535,Logan County",17,107,953500,Illinois
2289,1443,1374,69,1400000US17107953600,"Census Tract 9536,Logan County",17,107,953600,Illinois
2290,1686,1357,329,1400000US17109010100,"Census Tract 101,McDonough County",17,109,010100,Illinois
2291,875,752,123,1400000US17109010200,"Census Tract 102,McDonough County",17,109,010200,Illinois
2292,949,881,68,1400000US17109010300,"Census Tract 103,McDonough County",17,109,010300,Illinois
2293,644,403,241,1400000US17109010401,"Census Tract 104,01,McDonough County",17,109,010401,Illinois
2294,2246,1666,580,1400000US17109010402,"Census Tract 104,02,McDonough County",17,109,010402,Illinois
2295,1291,973,318,1400000US17109010600,"Census Tract 106,McDonough County",17,109,010600,Illinois
2296,2014,1806,208,1400000US17109010700,"Census Tract 107,McDonough County",17,109,010700,Illinois
2297,1431,1148,283,1400000US17109010900,"Census Tract 109,McDonough County",17,109,010900,Illinois
2298,1150,953,197,1400000US17109011000,"Census Tract 110,McDonough County",17,109,011000,Illinois
2299,1394,1290,104,1400000US17109011100,"Census Tract 111,McDonough County",17,109,011100,Illinois
2300,34,18,16,1400000US17109980000,"Census Tract 9800,McDonough County",17,109,980000,Illinois
2301,987,931,56,1400000US17111870103,"Census Tract 8701,03,McHenry County",17,111,870103,Illinois
2302,2369,2123,246,1400000US17111870104,"Census Tract 8701,04,McHenry County",17,111,870104,Illinois
2303,1250,1250,0,1400000US17111870105,"Census Tract 8701,05,McHenry County",17,111,870105,Illinois
2304,929,929,0,1400000US17111870106,"Census Tract 8701,06,McHenry County",17,111,870106,Illinois
2305,2353,2104,249,1400000US17111870200,"Census Tract 8702,McHenry County",17,111,870200,Illinois
2306,1761,1719,42,1400000US17111870301,"Census Tract 8703,01,McHenry County",17,111,870301,Illinois
2307,1454,1392,62,1400000US17111870302,"Census Tract 8703,02,McHenry County",17,111,870302,Illinois
2308,2215,2181,34,1400000US17111870402,"Census Tract 8704,02,McHenry County",17,111,870402,Illinois
2309,1599,1542,57,1400000US17111870403,"Census Tract 8704,03,McHenry County",17,111,870403,Illinois
2310,1426,1424,2,1400000US17111870404,"Census Tract 8704,04,McHenry County",17,111,870404,Illinois
2311,1639,1626,13,1400000US17111870501,"Census Tract 8705,01,McHenry County",17,111,870501,Illinois
2312,2025,1934,91,1400000US17111870502,"Census Tract 8705,02,McHenry County",17,111,870502,Illinois
2313,1838,1771,67,1400000US17111870603,"Census Tract 8706,03,McHenry County",17,111,870603,Illinois
2314,2531,2344,187,1400000US17111870604,"Census Tract 8706,04,McHenry County",17,111,870604,Illinois
2315,2594,2533,61,1400000US17111870605,"Census Tract 8706,05,McHenry County",17,111,870605,Illinois
2316,1630,1608,22,1400000US17111870606,"Census Tract 8706,06,McHenry County",17,111,870606,Illinois
2317,3330,3119,211,1400000US17111870702,"Census Tract 8707,02,McHenry County",17,111,870702,Illinois
2318,1947,1899,48,1400000US17111870703,"Census Tract 8707,03,McHenry County",17,111,870703,Illinois
2319,1541,1360,181,1400000US17111870704,"Census Tract 8707,04,McHenry County",17,111,870704,Illinois
2320,2058,1912,146,1400000US17111870807,"Census Tract 8708,07,McHenry County",17,111,870807,Illinois
2321,1376,1318,58,1400000US17111870808,"Census Tract 8708,08,McHenry County",17,111,870808,Illinois
2322,3011,2852,159,1400000US17111870809,"Census Tract 8708,09,McHenry County",17,111,870809,Illinois
2323,1642,1630,12,1400000US17111870810,"Census Tract 8708,10,McHenry County",17,111,870810,Illinois
2324,1930,1819,111,1400000US17111870811,"Census Tract 8708,11,McHenry County",17,111,870811,Illinois
2325,1753,1705,48,1400000US17111870812,"Census Tract 8708,12,McHenry County",17,111,870812,Illinois
2326,2095,2021,74,1400000US17111870813,"Census Tract 8708,13,McHenry County",17,111,870813,Illinois
2327,1352,1260,92,1400000US17111870814,"Census Tract 8708,14,McHenry County",17,111,870814,Illinois
2328,1460,1372,88,1400000US17111870903,"Census Tract 8709,03,McHenry County",17,111,870903,Illinois
2329,1973,1877,96,1400000US17111870904,"Census Tract 8709,04,McHenry County",17,111,870904,Illinois
2330,2137,2053,84,1400000US17111870905,"Census Tract 8709,05,McHenry County",17,111,870905,Illinois
2331,1919,1776,143,1400000US17111870906,"Census Tract 8709,06,McHenry County",17,111,870906,Illinois
2332,1182,1172,10,1400000US17111870907,"Census Tract 8709,07,McHenry County",17,111,870907,Illinois
2333,1734,1590,144,1400000US17111871003,"Census Tract 8710,03,McHenry County",17,111,871003,Illinois
2334,2485,2325,160,1400000US17111871004,"Census Tract 8710,04,McHenry County",17,111,871004,Illinois
2335,1756,1756,0,1400000US17111871105,"Census Tract 8711,05,McHenry County",17,111,871105,Illinois
2336,1750,1715,35,1400000US17111871107,"Census Tract 8711,07,McHenry County",17,111,871107,Illinois
2337,1795,1767,28,1400000US17111871108,"Census Tract 8711,08,McHenry County",17,111,871108,Illinois
2338,1572,1572,0,1400000US17111871109,"Census Tract 8711,09,McHenry County",17,111,871109,Illinois
2339,1238,1238,0,1400000US17111871110,"Census Tract 8711,10,McHenry County",17,111,871110,Illinois
2340,1706,1669,37,1400000US17111871111,"Census Tract 8711,11,McHenry County",17,111,871111,Illinois
2341,1998,1906,92,1400000US17111871112,"Census Tract 8711,12,McHenry County",17,111,871112,Illinois
2342,1167,1167,0,1400000US17111871113,"Census Tract 8711,13,McHenry County",17,111,871113,Illinois
2343,1305,1111,194,1400000US17111871114,"Census Tract 8711,14,McHenry County",17,111,871114,Illinois
2344,1321,1262,59,1400000US17111871115,"Census Tract 8711,15,McHenry County",17,111,871115,Illinois
2345,2759,2703,56,1400000US17111871201,"Census Tract 8712,01,McHenry County",17,111,871201,Illinois
2346,2064,1958,106,1400000US17111871202,"Census Tract 8712,02,McHenry County",17,111,871202,Illinois
2347,1600,1557,43,1400000US17111871205,"Census Tract 8712,05,McHenry County",17,111,871205,Illinois
2348,2647,2604,43,1400000US17111871206,"Census Tract 8712,06,McHenry County",17,111,871206,Illinois
2349,1747,1712,35,1400000US17111871207,"Census Tract 8712,07,McHenry County",17,111,871207,Illinois
2350,1422,1338,84,1400000US17111871208,"Census Tract 8712,08,McHenry County",17,111,871208,Illinois
2351,1602,1517,85,1400000US17111871209,"Census Tract 8712,09,McHenry County",17,111,871209,Illinois
2352,1917,1820,97,1400000US17111871301,"Census Tract 8713,01,McHenry County",17,111,871301,Illinois
2353,1346,1281,65,1400000US17111871304,"Census Tract 8713,04,McHenry County",17,111,871304,Illinois
2354,1942,1939,3,1400000US17111871305,"Census Tract 8713,05,McHenry County",17,111,871305,Illinois
2355,1847,1791,56,1400000US17111871307,"Census Tract 8713,07,McHenry County",17,111,871307,Illinois
2356,1688,1680,8,1400000US17111871310,"Census Tract 8713,10,McHenry County",17,111,871310,Illinois
2357,2027,1916,111,1400000US17111871311,"Census Tract 8713,11,McHenry County",17,111,871311,Illinois
2358,2068,2068,0,1400000US17111871312,"Census Tract 8713,12,McHenry County",17,111,871312,Illinois
2359,770,770,0,1400000US17111871313,"Census Tract 8713,13,McHenry County",17,111,871313,Illinois
2360,2596,2268,328,1400000US17111871402,"Census Tract 8714,02,McHenry County",17,111,871402,Illinois
2361,1657,1632,25,1400000US17111871404,"Census Tract 8714,04,McHenry County",17,111,871404,Illinois
2362,3391,3326,65,1400000US17111871501,"Census Tract 8715,01,McHenry County",17,111,871501,Illinois
2363,3020,2837,183,1400000US17111871502,"Census Tract 8715,02,McHenry County",17,111,871502,Illinois
2364,2222,2095,127,1400000US17111871600,"Census Tract 8716,McHenry County",17,111,871600,Illinois
2365,1868,1767,101,1400000US17113000105,"Census Tract 1,05,McLean County",17,113,000105,Illinois
2366,1753,1440,313,1400000US17113000106,"Census Tract 1,06,McLean County",17,113,000106,Illinois
2367,1844,1610,234,1400000US17113000107,"Census Tract 1,07,McLean County",17,113,000107,Illinois
2368,2806,2338,468,1400000US17113000108,"Census Tract 1,08,McLean County",17,113,000108,Illinois
2369,2001,2001,0,1400000US17113000109,"Census Tract 1,09,McLean County",17,113,000109,Illinois
2370,377,264,113,1400000US17113000200,"Census Tract 2,McLean County",17,113,000200,Illinois
2371,2132,1743,389,1400000US17113000301,"Census Tract 3,01,McLean County",17,113,000301,Illinois
2372,2748,2578,170,1400000US17113000302,"Census Tract 3,02,McLean County",17,113,000302,Illinois
2373,1292,1035,257,1400000US17113000400,"Census Tract 4,McLean County",17,113,000400,Illinois
2374,1529,1344,185,1400000US17113000501,"Census Tract 5,01,McLean County",17,113,000501,Illinois
2375,1148,1123,25,1400000US17113000502,"Census Tract 5,02,McLean County",17,113,000502,Illinois
2376,2343,2208,135,1400000US17113000504,"Census Tract 5,04,McLean County",17,113,000504,Illinois
2377,1141,1141,0,1400000US17113000506,"Census Tract 5,06,McLean County",17,113,000506,Illinois
2378,953,945,8,1400000US17113000507,"Census Tract 5,07,McLean County",17,113,000507,Illinois
2379,1482,1344,138,1400000US17113001103,"Census Tract 11,03,McLean County",17,113,001103,Illinois
2380,2210,2135,75,1400000US17113001105,"Census Tract 11,05,McLean County",17,113,001105,Illinois
2381,1560,1384,176,1400000US17113001106,"Census Tract 11,06,McLean County",17,113,001106,Illinois
2382,1525,1481,44,1400000US17113001107,"Census Tract 11,07,McLean County",17,113,001107,Illinois
2383,2099,1934,165,1400000US17113001108,"Census Tract 11,08,McLean County",17,113,001108,Illinois
2384,1331,1205,126,1400000US17113001200,"Census Tract 12,McLean County",17,113,001200,Illinois
2385,936,835,101,1400000US17113001301,"Census Tract 13,01,McLean County",17,113,001301,Illinois
2386,670,518,152,1400000US17113001302,"Census Tract 13,02,McLean County",17,113,001302,Illinois
2387,857,824,33,1400000US17113001303,"Census Tract 13,03,McLean County",17,113,001303,Illinois
2388,1338,1252,86,1400000US17113001402,"Census Tract 14,02,McLean County",17,113,001402,Illinois
2389,1994,1751,243,1400000US17113001403,"Census Tract 14,03,McLean County",17,113,001403,Illinois
2390,1743,1580,163,1400000US17113001404,"Census Tract 14,04,McLean County",17,113,001404,Illinois
2391,1098,898,200,1400000US17113001500,"Census Tract 15,McLean County",17,113,001500,Illinois
2392,1679,1469,210,1400000US17113001600,"Census Tract 16,McLean County",17,113,001600,Illinois
2393,1234,1058,176,1400000US17113001700,"Census Tract 17,McLean County",17,113,001700,Illinois
2394,1477,1425,52,1400000US17113001800,"Census Tract 18,McLean County",17,113,001800,Illinois
2395,2538,2344,194,1400000US17113002101,"Census Tract 21,01,McLean County",17,113,002101,Illinois
2396,711,693,18,1400000US17113002102,"Census Tract 21,02,McLean County",17,113,002102,Illinois
2397,3066,2741,325,1400000US17113005102,"Census Tract 51,02,McLean County",17,113,005102,Illinois
2398,1605,1566,39,1400000US17113005103,"Census Tract 51,03,McLean County",17,113,005103,Illinois
2399,2061,1989,72,1400000US17113005104,"Census Tract 51,04,McLean County",17,113,005104,Illinois
2400,422,398,24,1400000US17113005201,"Census Tract 52,01,McLean County",17,113,005201,Illinois
2401,1212,1131,81,1400000US17113005202,"Census Tract 52,02,McLean County",17,113,005202,Illinois
2402,2288,2234,54,1400000US17113005401,"Census Tract 54,01,McLean County",17,113,005401,Illinois
2403,1383,1317,66,1400000US17113005402,"Census Tract 54,02,McLean County",17,113,005402,Illinois
2404,968,920,48,1400000US17113005501,"Census Tract 55,01,McLean County",17,113,005501,Illinois
2405,978,961,17,1400000US17113005502,"Census Tract 55,02,McLean County",17,113,005502,Illinois
2406,764,660,104,1400000US17113005601,"Census Tract 56,01,McLean County",17,113,005601,Illinois
2407,956,851,105,1400000US17113005602,"Census Tract 56,02,McLean County",17,113,005602,Illinois
2408,2148,1896,252,1400000US17113005700,"Census Tract 57,McLean County",17,113,005700,Illinois
2409,2489,2136,353,1400000US17113005800,"Census Tract 58,McLean County",17,113,005800,Illinois
2410,2225,2084,141,1400000US17113005900,"Census Tract 59,McLean County",17,113,005900,Illinois
2411,1505,1349,156,1400000US17113006000,"Census Tract 60,McLean County",17,113,006000,Illinois
2412,1137,785,352,1400000US17115000200,"Census Tract 2,Macon County",17,115,000200,Illinois
2413,1695,1317,378,1400000US17115000300,"Census Tract 3,Macon County",17,115,000300,Illinois
2414,550,387,163,1400000US17115000400,"Census Tract 4,Macon County",17,115,000400,Illinois
2415,594,414,180,1400000US17115000501,"Census Tract 5,01,Macon County",17,115,000501,Illinois
2416,1511,992,519,1400000US17115000502,"Census Tract 5,02,Macon County",17,115,000502,Illinois
2417,846,663,183,1400000US17115000600,"Census Tract 6,Macon County",17,115,000600,Illinois
2418,813,642,171,1400000US17115000900,"Census Tract 9,Macon County",17,115,000900,Illinois
2419,590,534,56,1400000US17115001000,"Census Tract 10,Macon County",17,115,001000,Illinois
2420,1868,1638,230,1400000US17115001100,"Census Tract 11,Macon County",17,115,001100,Illinois
2421,1465,1137,328,1400000US17115001200,"Census Tract 12,Macon County",17,115,001200,Illinois
2422,1114,1023,91,1400000US17115001300,"Census Tract 13,Macon County",17,115,001300,Illinois
2423,1174,1142,32,1400000US17115001400,"Census Tract 14,Macon County",17,115,001400,Illinois
2424,1933,1818,115,1400000US17115001500,"Census Tract 15,Macon County",17,115,001500,Illinois
2425,767,631,136,1400000US17115001600,"Census Tract 16,Macon County",17,115,001600,Illinois
2426,955,770,185,1400000US17115001700,"Census Tract 17,Macon County",17,115,001700,Illinois
2427,1026,915,111,1400000US17115001801,"Census Tract 18,01,Macon County",17,115,001801,Illinois
2428,1163,866,297,1400000US17115001802,"Census Tract 18,02,Macon County",17,115,001802,Illinois
2429,1334,1204,130,1400000US17115001900,"Census Tract 19,Macon County",17,115,001900,Illinois
2430,715,674,41,1400000US17115002001,"Census Tract 20,01,Macon County",17,115,002001,Illinois
2431,1357,1015,342,1400000US17115002002,"Census Tract 20,02,Macon County",17,115,002002,Illinois
2432,724,594,130,1400000US17115002100,"Census Tract 21,Macon County",17,115,002100,Illinois
2433,2293,2050,243,1400000US17115002200,"Census Tract 22,Macon County",17,115,002200,Illinois
2434,1184,1095,89,1400000US17115002300,"Census Tract 23,Macon County",17,115,002300,Illinois
2435,1064,1064,0,1400000US17115002401,"Census Tract 24,01,Macon County",17,115,002401,Illinois
2436,2388,2175,213,1400000US17115002402,"Census Tract 24,02,Macon County",17,115,002402,Illinois
2437,2824,2627,197,1400000US17115002500,"Census Tract 25,Macon County",17,115,002500,Illinois
2438,1895,1780,115,1400000US17115002601,"Census Tract 26,01,Macon County",17,115,002601,Illinois
2439,812,706,106,1400000US17115002602,"Census Tract 26,02,Macon County",17,115,002602,Illinois
2440,1007,917,90,1400000US17115002700,"Census Tract 27,Macon County",17,115,002700,Illinois
2441,1730,1537,193,1400000US17115002800,"Census Tract 28,Macon County",17,115,002800,Illinois
2442,1650,1605,45,1400000US17115002901,"Census Tract 29,01,Macon County",17,115,002901,Illinois
2443,2104,2037,67,1400000US17115002902,"Census Tract 29,02,Macon County",17,115,002902,Illinois
2444,2628,2429,199,1400000US17115002904,"Census Tract 29,04,Macon County",17,115,002904,Illinois
2445,635,595,40,1400000US17115002905,"Census Tract 29,05,Macon County",17,115,002905,Illinois
2446,1817,1538,279,1400000US17115002906,"Census Tract 29,06,Macon County",17,115,002906,Illinois
2447,1493,1326,167,1400000US17115003000,"Census Tract 30,Macon County",17,115,003000,Illinois
2448,977,622,355,1400000US17115003100,"Census Tract 31,Macon County",17,115,003100,Illinois
2449,1497,1278,219,1400000US17117956000,"Census Tract 9560,Macoupin County",17,117,956000,Illinois
2450,1509,1137,372,1400000US17117956100,"Census Tract 9561,Macoupin County",17,117,956100,Illinois
2451,1287,1025,262,1400000US17117956200,"Census Tract 9562,Macoupin County",17,117,956200,Illinois
2452,1311,1054,257,1400000US17117956300,"Census Tract 9563,Macoupin County",17,117,956300,Illinois
2453,2325,2052,273,1400000US17117956400,"Census Tract 9564,Macoupin County",17,117,956400,Illinois
2454,1172,935,237,1400000US17117956500,"Census Tract 9565,Macoupin County",17,117,956500,Illinois
2455,2028,1698,330,1400000US17117956600,"Census Tract 9566,Macoupin County",17,117,956600,Illinois
2456,1726,1408,318,1400000US17117956700,"Census Tract 9567,Macoupin County",17,117,956700,Illinois
2457,1198,971,227,1400000US17117956800,"Census Tract 9568,Macoupin County",17,117,956800,Illinois
2458,1660,1458,202,1400000US17117956900,"Census Tract 9569,Macoupin County",17,117,956900,Illinois
2459,1942,1427,515,1400000US17117957000,"Census Tract 9570,Macoupin County",17,117,957000,Illinois
2460,1292,1192,100,1400000US17117957100,"Census Tract 9571,Macoupin County",17,117,957100,Illinois
2461,2167,2014,153,1400000US17117957200,"Census Tract 9572,Macoupin County",17,117,957200,Illinois
2462,1253,1147,106,1400000US17119400101,"Census Tract 4001,01,Madison County",17,119,400101,Illinois
2463,2258,1938,320,1400000US17119400102,"Census Tract 4001,02,Madison County",17,119,400102,Illinois
2464,1773,1486,287,1400000US17119400200,"Census Tract 4002,Madison County",17,119,400200,Illinois
2465,1345,1057,288,1400000US17119400600,"Census Tract 4006,Madison County",17,119,400600,Illinois
2466,1014,770,244,1400000US17119400700,"Census Tract 4007,Madison County",17,119,400700,Illinois
2467,760,742,18,1400000US17119400801,"Census Tract 4008,01,Madison County",17,119,400801,Illinois
2468,2796,2672,124,1400000US17119400802,"Census Tract 4008,02,Madison County",17,119,400802,Illinois
2469,2200,1809,391,1400000US17119400903,"Census Tract 4009,03,Madison County",17,119,400903,Illinois
2470,1499,1375,124,1400000US17119400904,"Census Tract 4009,04,Madison County",17,119,400904,Illinois
2471,2286,2014,272,1400000US17119400951,"Census Tract 4009,51,Madison County",17,119,400951,Illinois
2472,1528,1269,259,1400000US17119400952,"Census Tract 4009,52,Madison County",17,119,400952,Illinois
2473,1186,1033,153,1400000US17119401000,"Census Tract 4010,Madison County",17,119,401000,Illinois
2474,1442,1153,289,1400000US17119401101,"Census Tract 4011,01,Madison County",17,119,401101,Illinois
2475,1596,1483,113,1400000US17119401102,"Census Tract 4011,02,Madison County",17,119,401102,Illinois
2476,960,861,99,1400000US17119401200,"Census Tract 4012,Madison County",17,119,401200,Illinois
2477,2632,2207,425,1400000US17119401300,"Census Tract 4013,Madison County",17,119,401300,Illinois
2478,1551,1290,261,1400000US17119401400,"Census Tract 4014,Madison County",17,119,401400,Illinois
2479,1270,1199,71,1400000US17119401500,"Census Tract 4015,Madison County",17,119,401500,Illinois
2480,887,866,21,1400000US17119401701,"Census Tract 4017,01,Madison County",17,119,401701,Illinois
2481,2476,2236,240,1400000US17119401721,"Census Tract 4017,21,Madison County",17,119,401721,Illinois
2482,1418,1298,120,1400000US17119401722,"Census Tract 4017,22,Madison County",17,119,401722,Illinois
2483,2607,2393,214,1400000US17119401800,"Census Tract 4018,Madison County",17,119,401800,Illinois
2484,797,741,56,1400000US17119401901,"Census Tract 4019,01,Madison County",17,119,401901,Illinois
2485,2146,1978,168,1400000US17119401905,"Census Tract 4019,05,Madison County",17,119,401905,Illinois
2486,2163,2031,132,1400000US17119402000,"Census Tract 4020,Madison County",17,119,402000,Illinois
2487,1396,1142,254,1400000US17119402100,"Census Tract 4021,Madison County",17,119,402100,Illinois
2488,1495,1401,94,1400000US17119402200,"Census Tract 4022,Madison County",17,119,402200,Illinois
2489,905,778,127,1400000US17119402300,"Census Tract 4023,Madison County",17,119,402300,Illinois
2490,1093,813,280,1400000US17119402400,"Census Tract 4024,Madison County",17,119,402400,Illinois
2491,956,688,268,1400000US17119402500,"Census Tract 4025,Madison County",17,119,402500,Illinois
2492,1293,1055,238,1400000US17119402600,"Census Tract 4026,Madison County",17,119,402600,Illinois
2493,3356,3137,219,1400000US17119402701,"Census Tract 4027,01,Madison County",17,119,402701,Illinois
2494,3443,3286,157,1400000US17119402721,"Census Tract 4027,21,Madison County",17,119,402721,Illinois
2495,1232,1194,38,1400000US17119402722,"Census Tract 4027,22,Madison County",17,119,402722,Illinois
2496,1746,1641,105,1400000US17119402801,"Census Tract 4028,01,Madison County",17,119,402801,Illinois
2497,1387,1141,246,1400000US17119402803,"Census Tract 4028,03,Madison County",17,119,402803,Illinois
2498,968,938,30,1400000US17119402804,"Census Tract 4028,04,Madison County",17,119,402804,Illinois
2499,2298,2081,217,1400000US17119402805,"Census Tract 4028,05,Madison County",17,119,402805,Illinois
2500,2145,2047,98,1400000US17119402900,"Census Tract 4029,Madison County",17,119,402900,Illinois
2501,2425,2304,121,1400000US17119403001,"Census Tract 4030,01,Madison County",17,119,403001,Illinois
2502,2757,2506,251,1400000US17119403002,"Census Tract 4030,02,Madison County",17,119,403002,Illinois
2503,1808,1538,270,1400000US17119403101,"Census Tract 4031,01,Madison County",17,119,403101,Illinois
2504,4010,3829,181,1400000US17119403121,"Census Tract 4031,21,Madison County",17,119,403121,Illinois
2505,2432,2268,164,1400000US17119403122,"Census Tract 4031,22,Madison County",17,119,403122,Illinois
2506,2218,2082,136,1400000US17119403200,"Census Tract 4032,Madison County",17,119,403200,Illinois
2507,1398,1176,222,1400000US17119403300,"Census Tract 4033,Madison County",17,119,403300,Illinois
2508,1860,1739,121,1400000US17119403401,"Census Tract 4034,01,Madison County",17,119,403401,Illinois
2509,1333,1333,0,1400000US17119403403,"Census Tract 4034,03,Madison County",17,119,403403,Illinois
2510,1538,1395,143,1400000US17119403404,"Census Tract 4034,04,Madison County",17,119,403404,Illinois
2511,2472,2308,164,1400000US17119403502,"Census Tract 4035,02,Madison County",17,119,403502,Illinois
2512,3367,3234,133,1400000US17119403531,"Census Tract 4035,31,Madison County",17,119,403531,Illinois
2513,1920,1886,34,1400000US17119403532,"Census Tract 4035,32,Madison County",17,119,403532,Illinois
2514,4431,4318,113,1400000US17119403533,"Census Tract 4035,33,Madison County",17,119,403533,Illinois
2515,1879,1845,34,1400000US17119403534,"Census Tract 4035,34,Madison County",17,119,403534,Illinois
2516,1730,1730,0,1400000US17119403601,"Census Tract 4036,01,Madison County",17,119,403601,Illinois
2517,793,764,29,1400000US17119403603,"Census Tract 4036,03,Madison County",17,119,403603,Illinois
2518,2980,2888,92,1400000US17119403604,"Census Tract 4036,04,Madison County",17,119,403604,Illinois
2519,2410,2298,112,1400000US17119403701,"Census Tract 4037,01,Madison County",17,119,403701,Illinois
2520,2228,2048,180,1400000US17119403702,"Census Tract 4037,02,Madison County",17,119,403702,Illinois
2521,2119,2060,59,1400000US17119403801,"Census Tract 4038,01,Madison County",17,119,403801,Illinois
2522,1966,1811,155,1400000US17119403802,"Census Tract 4038,02,Madison County",17,119,403802,Illinois
2523,1392,1064,328,1400000US17119404000,"Census Tract 4040,Madison County",17,119,404000,Illinois
2524,1496,1423,73,1400000US17119404100,"Census Tract 4041,Madison County",17,119,404100,Illinois
2525,1606,1432,174,1400000US17121951600,"Census Tract 9516,Marion County",17,121,951600,Illinois
2526,1260,1063,197,1400000US17121951700,"Census Tract 9517,Marion County",17,121,951700,Illinois
2527,1042,926,116,1400000US17121951800,"Census Tract 9518,Marion County",17,121,951800,Illinois
2528,1296,1127,169,1400000US17121951900,"Census Tract 9519,Marion County",17,121,951900,Illinois
2529,1871,1803,68,1400000US17121952000,"Census Tract 9520,Marion County",17,121,952000,Illinois
2530,1547,1339,208,1400000US17121952100,"Census Tract 9521,Marion County",17,121,952100,Illinois
2531,1699,1544,155,1400000US17121952200,"Census Tract 9522,Marion County",17,121,952200,Illinois
2532,1572,1292,280,1400000US17121952300,"Census Tract 9523,Marion County",17,121,952300,Illinois
2533,1803,1686,117,1400000US17121952400,"Census Tract 9524,Marion County",17,121,952400,Illinois
2534,1192,977,215,1400000US17121952500,"Census Tract 9525,Marion County",17,121,952500,Illinois
2535,1000,805,195,1400000US17121952600,"Census Tract 9526,Marion County",17,121,952600,Illinois
2536,1582,1300,282,1400000US17121952700,"Census Tract 9527,Marion County",17,121,952700,Illinois
2537,1445,1099,346,1400000US17123961100,"Census Tract 9611,Marshall County",17,123,961100,Illinois
2538,1171,1068,103,1400000US17123961200,"Census Tract 9612,Marshall County",17,123,961200,Illinois
2539,987,910,77,1400000US17123961300,"Census Tract 9613,Marshall County",17,123,961300,Illinois
2540,1249,1033,216,1400000US17123961400,"Census Tract 9614,Marshall County",17,123,961400,Illinois
2541,983,782,201,1400000US17123961500,"Census Tract 9615,Marshall County",17,123,961500,Illinois
2542,1212,1148,64,1400000US17125956300,"Census Tract 9563,Mason County",17,125,956300,Illinois
2543,1001,788,213,1400000US17125956400,"Census Tract 9564,Mason County",17,125,956400,Illinois
2544,1585,1463,122,1400000US17125956500,"Census Tract 9565,Mason County",17,125,956500,Illinois
2545,963,685,278,1400000US17125956600,"Census Tract 9566,Mason County",17,125,956600,Illinois
2546,766,689,77,1400000US17125956700,"Census Tract 9567,Mason County",17,125,956700,Illinois
2547,1161,1017,144,1400000US17125956800,"Census Tract 9568,Mason County",17,125,956800,Illinois
2548,1932,1648,284,1400000US17127970100,"Census Tract 9701,Massac County",17,127,970100,Illinois
2549,1898,1536,362,1400000US17127970200,"Census Tract 9702,Massac County",17,127,970200,Illinois
2550,1630,1276,354,1400000US17127970300,"Census Tract 9703,Massac County",17,127,970300,Illinois
2551,1380,1006,374,1400000US17127970400,"Census Tract 9704,Massac County",17,127,970400,Illinois
2552,2594,2351,243,1400000US17129010100,"Census Tract 101,Menard County",17,129,010100,Illinois
2553,1894,1751,143,1400000US17129010200,"Census Tract 102,Menard County",17,129,010200,Illinois
2554,1120,1012,108,1400000US17129010300,"Census Tract 103,Menard County",17,129,010300,Illinois
2555,1968,1743,225,1400000US17131040100,"Census Tract 401,Mercer County",17,131,040100,Illinois
2556,1641,1361,280,1400000US17131040200,"Census Tract 402,Mercer County",17,131,040200,Illinois
2557,1868,1609,259,1400000US17131040300,"Census Tract 403,Mercer County",17,131,040300,Illinois
2558,1822,1626,196,1400000US17131040400,"Census Tract 404,Mercer County",17,131,040400,Illinois
2559,1886,1658,228,1400000US17133600102,"Census Tract 6001,02,Monroe County",17,133,600102,Illinois
2560,1570,1472,98,1400000US17133600103,"Census Tract 6001,03,Monroe County",17,133,600103,Illinois
2561,1853,1853,0,1400000US17133600104,"Census Tract 6001,04,Monroe County",17,133,600104,Illinois
2562,3184,3082,102,1400000US17133600401,"Census Tract 6004,01,Monroe County",17,133,600401,Illinois
2563,1858,1698,160,1400000US17133600402,"Census Tract 6004,02,Monroe County",17,133,600402,Illinois
2564,2704,2505,199,1400000US17133600501,"Census Tract 6005,01,Monroe County",17,133,600501,Illinois
2565,1383,1211,172,1400000US17133600502,"Census Tract 6005,02,Monroe County",17,133,600502,Illinois
2566,1499,1325,174,1400000US17135957300,"Census Tract 9573,Montgomery County",17,135,957300,Illinois
2567,979,865,114,1400000US17135957400,"Census Tract 9574,Montgomery County",17,135,957400,Illinois
2568,1267,1112,155,1400000US17135957500,"Census Tract 9575,Montgomery County",17,135,957500,Illinois
2569,1595,1409,186,1400000US17135957600,"Census Tract 9576,Montgomery County",17,135,957600,Illinois
2570,1447,1255,192,1400000US17135957700,"Census Tract 9577,Montgomery County",17,135,957700,Illinois
2571,1699,1587,112,1400000US17135957800,"Census Tract 9578,Montgomery County",17,135,957800,Illinois
2572,2291,1979,312,1400000US17135957900,"Census Tract 9579,Montgomery County",17,135,957900,Illinois
2573,1804,1613,191,1400000US17135958000,"Census Tract 9580,Montgomery County",17,135,958000,Illinois
2574,1251,1003,248,1400000US17137951400,"Census Tract 9514,Morgan County",17,137,951400,Illinois
2575,1240,1011,229,1400000US17137951500,"Census Tract 9515,Morgan County",17,137,951500,Illinois
2576,1572,1217,355,1400000US17137951600,"Census Tract 9516,Morgan County",17,137,951600,Illinois
2577,1171,921,250,1400000US17137951700,"Census Tract 9517,Morgan County",17,137,951700,Illinois
2578,1656,1501,155,1400000US17137951800,"Census Tract 9518,Morgan County",17,137,951800,Illinois
2579,2017,1905,112,1400000US17137951900,"Census Tract 9519,Morgan County",17,137,951900,Illinois
2580,1579,1490,89,1400000US17137952000,"Census Tract 9520,Morgan County",17,137,952000,Illinois
2581,1785,1645,140,1400000US17137952100,"Census Tract 9521,Morgan County",17,137,952100,Illinois
2582,1372,1248,124,1400000US17137952200,"Census Tract 9522,Morgan County",17,137,952200,Illinois
2583,1439,1246,193,1400000US17137952300,"Census Tract 9523,Morgan County",17,137,952300,Illinois
2584,1821,1754,67,1400000US17139976900,"Census Tract 9769,Moultrie County",17,139,976900,Illinois
2585,1182,1080,102,1400000US17139977000,"Census Tract 9770,Moultrie County",17,139,977000,Illinois
2586,1336,1236,100,1400000US17139977100,"Census Tract 9771,Moultrie County",17,139,977100,Illinois
2587,1833,1683,150,1400000US17139977200,"Census Tract 9772,Moultrie County",17,139,977200,Illinois
2588,1803,1628,175,1400000US17141960700,"Census Tract 9607,Ogle County",17,141,960700,Illinois
2589,1429,1363,66,1400000US17141960800,"Census Tract 9608,Ogle County",17,141,960800,Illinois
2590,2279,2119,160,1400000US17141960900,"Census Tract 9609,Ogle County",17,141,960900,Illinois
2591,1301,1128,173,1400000US17141961001,"Census Tract 9610,01,Ogle County",17,141,961001,Illinois
2592,1327,1172,155,1400000US17141961002,"Census Tract 9610,02,Ogle County",17,141,961002,Illinois
2593,1848,1780,68,1400000US17141961100,"Census Tract 9611,Ogle County",17,141,961100,Illinois
2594,2773,2653,120,1400000US17141961200,"Census Tract 9612,Ogle County",17,141,961200,Illinois
2595,1140,871,269,1400000US17141961301,"Census Tract 9613,01,Ogle County",17,141,961301,Illinois
2596,1114,1042,72,1400000US17141961302,"Census Tract 9613,02,Ogle County",17,141,961302,Illinois
2597,2065,1883,182,1400000US17141961400,"Census Tract 9614,Ogle County",17,141,961400,Illinois
2598,2098,1937,161,1400000US17141961500,"Census Tract 9615,Ogle County",17,141,961500,Illinois
2599,1499,1387,112,1400000US17141961600,"Census Tract 9616,Ogle County",17,141,961600,Illinois
2600,1961,1808,153,1400000US17141961700,"Census Tract 9617,Ogle County",17,141,961700,Illinois
2601,796,663,133,1400000US17143000200,"Census Tract 2,Peoria County",17,143,000200,Illinois
2602,837,527,310,1400000US17143000300,"Census Tract 3,Peoria County",17,143,000300,Illinois
2603,1395,1164,231,1400000US17143000600,"Census Tract 6,Peoria County",17,143,000600,Illinois
2604,1435,1271,164,1400000US17143000900,"Census Tract 9,Peoria County",17,143,000900,Illinois
2605,975,632,343,1400000US17143001200,"Census Tract 12,Peoria County",17,143,001200,Illinois
2606,1023,789,234,1400000US17143001300,"Census Tract 13,Peoria County",17,143,001300,Illinois
2607,825,689,136,1400000US17143001500,"Census Tract 15,Peoria County",17,143,001500,Illinois
2608,2067,1545,522,1400000US17143001600,"Census Tract 16,Peoria County",17,143,001600,Illinois
2609,1548,1215,333,1400000US17143001800,"Census Tract 18,Peoria County",17,143,001800,Illinois
2610,619,521,98,1400000US17143001900,"Census Tract 19,Peoria County",17,143,001900,Illinois
2611,616,476,140,1400000US17143002000,"Census Tract 20,Peoria County",17,143,002000,Illinois
2612,1991,1715,276,1400000US17143002100,"Census Tract 21,Peoria County",17,143,002100,Illinois
2613,1834,1661,173,1400000US17143002200,"Census Tract 22,Peoria County",17,143,002200,Illinois
2614,2423,2247,176,1400000US17143002300,"Census Tract 23,Peoria County",17,143,002300,Illinois
2615,2422,2157,265,1400000US17143002400,"Census Tract 24,Peoria County",17,143,002400,Illinois
2616,1558,1194,364,1400000US17143002500,"Census Tract 25,Peoria County",17,143,002500,Illinois
2617,833,771,62,1400000US17143002600,"Census Tract 26,Peoria County",17,143,002600,Illinois
2618,1668,1512,156,1400000US17143002701,"Census Tract 27,01,Peoria County",17,143,002701,Illinois
2619,1885,1687,198,1400000US17143002702,"Census Tract 27,02,Peoria County",17,143,002702,Illinois
2620,1788,1653,135,1400000US17143002800,"Census Tract 28,Peoria County",17,143,002800,Illinois
2621,1950,1737,213,1400000US17143002900,"Census Tract 29,Peoria County",17,143,002900,Illinois
2622,2187,2069,118,1400000US17143003000,"Census Tract 30,Peoria County",17,143,003000,Illinois
2623,2419,2145,274,1400000US17143003101,"Census Tract 31,01,Peoria County",17,143,003101,Illinois
2624,1638,1379,259,1400000US17143003103,"Census Tract 31,03,Peoria County",17,143,003103,Illinois
2625,1586,1482,104,1400000US17143003104,"Census Tract 31,04,Peoria County",17,143,003104,Illinois
2626,2351,2216,135,1400000US17143003200,"Census Tract 32,Peoria County",17,143,003200,Illinois
2627,1430,1399,31,1400000US17143003300,"Census Tract 33,Peoria County",17,143,003300,Illinois
2628,1888,1713,175,1400000US17143003402,"Census Tract 34,02,Peoria County",17,143,003402,Illinois
2629,1598,1349,249,1400000US17143003403,"Census Tract 34,03,Peoria County",17,143,003403,Illinois
2630,3596,3440,156,1400000US17143003404,"Census Tract 34,04,Peoria County",17,143,003404,Illinois
2631,1127,985,142,1400000US17143003601,"Census Tract 36,01,Peoria County",17,143,003601,Illinois
2632,2701,2600,101,1400000US17143003602,"Census Tract 36,02,Peoria County",17,143,003602,Illinois
2633,1457,1256,201,1400000US17143003700,"Census Tract 37,Peoria County",17,143,003700,Illinois
2634,1324,1243,81,1400000US17143003800,"Census Tract 38,Peoria County",17,143,003800,Illinois
2635,3196,3113,83,1400000US17143003900,"Census Tract 39,Peoria County",17,143,003900,Illinois
2636,1838,1701,137,1400000US17143004000,"Census Tract 40,Peoria County",17,143,004000,Illinois
2637,2876,2717,159,1400000US17143004101,"Census Tract 41,01,Peoria County",17,143,004101,Illinois
2638,1483,1314,169,1400000US17143004102,"Census Tract 41,02,Peoria County",17,143,004102,Illinois
2639,2061,1812,249,1400000US17143004200,"Census Tract 42,Peoria County",17,143,004200,Illinois
2640,1170,990,180,1400000US17143004300,"Census Tract 43,Peoria County",17,143,004300,Illinois
2641,2254,1879,375,1400000US17143004400,"Census Tract 44,Peoria County",17,143,004400,Illinois
2642,1883,1826,57,1400000US17143004500,"Census Tract 45,Peoria County",17,143,004500,Illinois
2643,2276,2083,193,1400000US17143004600,"Census Tract 46,Peoria County",17,143,004600,Illinois
2644,2030,1864,166,1400000US17143004801,"Census Tract 48,01,Peoria County",17,143,004801,Illinois
2645,1934,1676,258,1400000US17143004802,"Census Tract 48,02,Peoria County",17,143,004802,Illinois
2646,1469,1361,108,1400000US17143004901,"Census Tract 49,01,Peoria County",17,143,004901,Illinois
2647,2118,1893,225,1400000US17143004902,"Census Tract 49,02,Peoria County",17,143,004902,Illinois
2648,1174,945,229,1400000US17143005000,"Census Tract 50,Peoria County",17,143,005000,Illinois
2649,1362,1076,286,1400000US17143005100,"Census Tract 51,Peoria County",17,143,005100,Illinois
2650,1368,1167,201,1400000US17145030100,"Census Tract 301,Perry County",17,145,030100,Illinois
2651,2656,2444,212,1400000US17145030200,"Census Tract 302,Perry County",17,145,030200,Illinois
2652,890,768,122,1400000US17145030300,"Census Tract 303,Perry County",17,145,030300,Illinois
2653,1263,1020,243,1400000US17145030400,"Census Tract 304,Perry County",17,145,030400,Illinois
2654,1064,985,79,1400000US17145030500,"Census Tract 305,Perry County",17,145,030500,Illinois
2655,1925,1724,201,1400000US17145030600,"Census Tract 306,Perry County",17,145,030600,Illinois
2656,1785,1589,196,1400000US17147954500,"Census Tract 9545,Piatt County",17,147,954500,Illinois
2657,2945,2767,178,1400000US17147954600,"Census Tract 9546,Piatt County",17,147,954600,Illinois
2658,1461,1240,221,1400000US17147954700,"Census Tract 9547,Piatt County",17,147,954700,Illinois
2659,1168,1090,78,1400000US17147954800,"Census Tract 9548,Piatt County",17,147,954800,Illinois
2660,1568,1297,271,1400000US17149952400,"Census Tract 9524,Pike County",17,149,952400,Illinois
2661,1126,952,174,1400000US17149952500,"Census Tract 9525,Pike County",17,149,952500,Illinois
2662,1504,977,527,1400000US17149952600,"Census Tract 9526,Pike County",17,149,952600,Illinois
2663,2045,1823,222,1400000US17149952700,"Census Tract 9527,Pike County",17,149,952700,Illinois
2664,1089,707,382,1400000US17149952800,"Census Tract 9528,Pike County",17,149,952800,Illinois
2665,1301,713,588,1400000US17151971200,"Census Tract 9712,Pope County",17,151,971200,Illinois
2666,1069,659,410,1400000US17151971300,"Census Tract 9713,Pope County",17,151,971300,Illinois
2667,1338,920,418,1400000US17153971000,"Census Tract 9710,Pulaski County",17,153,971000,Illinois
2668,1538,937,601,1400000US17153971100,"Census Tract 9711,Pulaski County",17,153,971100,Illinois
2669,1368,1159,209,1400000US17155954500,"Census Tract 9545,Putnam County",17,155,954500,Illinois
2670,1701,1139,562,1400000US17155954600,"Census Tract 9546,Putnam County",17,155,954600,Illinois
2671,1010,826,184,1400000US17157950500,"Census Tract 9505,Randolph County",17,157,950500,Illinois
2672,2109,1802,307,1400000US17157950600,"Census Tract 9506,Randolph County",17,157,950600,Illinois
2673,1128,939,189,1400000US17157950700,"Census Tract 9507,Randolph County",17,157,950700,Illinois
2674,2009,1893,116,1400000US17157950800,"Census Tract 9508,Randolph County",17,157,950800,Illinois
2675,1651,1316,335,1400000US17157950900,"Census Tract 9509,Randolph County",17,157,950900,Illinois
2676,1020,922,98,1400000US17157951000,"Census Tract 9510,Randolph County",17,157,951000,Illinois
2677,1717,1462,255,1400000US17157951100,"Census Tract 9511,Randolph County",17,157,951100,Illinois
2678,892,795,97,1400000US17157951201,"Census Tract 9512,01,Randolph County",17,157,951201,Illinois
2679,239,224,15,1400000US17157951202,"Census Tract 9512,02,Randolph County",17,157,951202,Illinois
2680,1650,1359,291,1400000US17157951300,"Census Tract 9513,Randolph County",17,157,951300,Illinois
2681,1760,1599,161,1400000US17159977900,"Census Tract 9779,Richland County",17,159,977900,Illinois
2682,1037,783,254,1400000US17159978000,"Census Tract 9780,Richland County",17,159,978000,Illinois
2683,1786,1595,191,1400000US17159978100,"Census Tract 9781,Richland County",17,159,978100,Illinois
2684,1416,1157,259,1400000US17159978200,"Census Tract 9782,Richland County",17,159,978200,Illinois
2685,1382,1247,135,1400000US17159978300,"Census Tract 9783,Richland County",17,159,978300,Illinois
2686,1163,972,191,1400000US17161020101,"Census Tract 201,01,Rock Island County",17,161,020101,Illinois
2687,1538,1474,64,1400000US17161020102,"Census Tract 201,02,Rock Island County",17,161,020102,Illinois
2688,432,410,22,1400000US17161020103,"Census Tract 201,03,Rock Island County",17,161,020103,Illinois
2689,1658,1517,141,1400000US17161020200,"Census Tract 202,Rock Island County",17,161,020200,Illinois
2690,2403,2187,216,1400000US17161020301,"Census Tract 203,01,Rock Island County",17,161,020301,Illinois
2691,1361,1189,172,1400000US17161020302,"Census Tract 203,02,Rock Island County",17,161,020302,Illinois
2692,2287,2228,59,1400000US17161020400,"Census Tract 204,Rock Island County",17,161,020400,Illinois
2693,942,842,100,1400000US17161020600,"Census Tract 206,Rock Island County",17,161,020600,Illinois
2694,784,639,145,1400000US17161020700,"Census Tract 207,Rock Island County",17,161,020700,Illinois
2695,2065,1876,189,1400000US17161020800,"Census Tract 208,Rock Island County",17,161,020800,Illinois
2696,2203,2135,68,1400000US17161020900,"Census Tract 209,Rock Island County",17,161,020900,Illinois
2697,1916,1779,137,1400000US17161021000,"Census Tract 210,Rock Island County",17,161,021000,Illinois
2698,1813,1670,143,1400000US17161021100,"Census Tract 211,Rock Island County",17,161,021100,Illinois
2699,2098,1947,151,1400000US17161021200,"Census Tract 212,Rock Island County",17,161,021200,Illinois
2700,2505,2267,238,1400000US17161021300,"Census Tract 213,Rock Island County",17,161,021300,Illinois
2701,610,554,56,1400000US17161021400,"Census Tract 214,Rock Island County",17,161,021400,Illinois
2702,2100,2071,29,1400000US17161021500,"Census Tract 215,Rock Island County",17,161,021500,Illinois
2703,1187,1014,173,1400000US17161021600,"Census Tract 216,Rock Island County",17,161,021600,Illinois
2704,1626,1372,254,1400000US17161021700,"Census Tract 217,Rock Island County",17,161,021700,Illinois
2705,2066,1996,70,1400000US17161021800,"Census Tract 218,Rock Island County",17,161,021800,Illinois
2706,875,789,86,1400000US17161021900,"Census Tract 219,Rock Island County",17,161,021900,Illinois
2707,1747,1665,82,1400000US17161022000,"Census Tract 220,Rock Island County",17,161,022000,Illinois
2708,1321,1267,54,1400000US17161022100,"Census Tract 221,Rock Island County",17,161,022100,Illinois
2709,1520,1308,212,1400000US17161022200,"Census Tract 222,Rock Island County",17,161,022200,Illinois
2710,1153,911,242,1400000US17161022300,"Census Tract 223,Rock Island County",17,161,022300,Illinois
2711,1387,1073,314,1400000US17161022600,"Census Tract 226,Rock Island County",17,161,022600,Illinois
2712,1567,1376,191,1400000US17161022800,"Census Tract 228,Rock Island County",17,161,022800,Illinois
2713,1329,1270,59,1400000US17161022900,"Census Tract 229,Rock Island County",17,161,022900,Illinois
2714,1778,1687,91,1400000US17161023000,"Census Tract 230,Rock Island County",17,161,023000,Illinois
2715,1204,1131,73,1400000US17161023100,"Census Tract 231,Rock Island County",17,161,023100,Illinois
2716,2474,2377,97,1400000US17161023200,"Census Tract 232,Rock Island County",17,161,023200,Illinois
2717,1578,1315,263,1400000US17161023300,"Census Tract 233,Rock Island County",17,161,023300,Illinois
2718,784,654,130,1400000US17161023500,"Census Tract 235,Rock Island County",17,161,023500,Illinois
2719,784,589,195,1400000US17161023600,"Census Tract 236,Rock Island County",17,161,023600,Illinois
2720,1085,943,142,1400000US17161023700,"Census Tract 237,Rock Island County",17,161,023700,Illinois
2721,1948,1787,161,1400000US17161024000,"Census Tract 240,Rock Island County",17,161,024000,Illinois
2722,1694,1554,140,1400000US17161024101,"Census Tract 241,01,Rock Island County",17,161,024101,Illinois
2723,2304,2138,166,1400000US17161024102,"Census Tract 241,02,Rock Island County",17,161,024102,Illinois
2724,1682,1554,128,1400000US17161024103,"Census Tract 241,03,Rock Island County",17,161,024103,Illinois
2725,2154,2074,80,1400000US17161024200,"Census Tract 242,Rock Island County",17,161,024200,Illinois
2726,1441,1355,86,1400000US17161024300,"Census Tract 243,Rock Island County",17,161,024300,Illinois
2727,1114,978,136,1400000US17161024400,"Census Tract 244,Rock Island County",17,161,024400,Illinois
2728,987,760,227,1400000US17161024500,"Census Tract 245,Rock Island County",17,161,024500,Illinois
2729,1245,842,403,1400000US17163500400,"Census Tract 5004,St, Clair County",17,163,500400,Illinois
2730,937,638,299,1400000US17163500500,"Census Tract 5005,St, Clair County",17,163,500500,Illinois
2731,1579,1145,434,1400000US17163500900,"Census Tract 5009,St, Clair County",17,163,500900,Illinois
2732,594,444,150,1400000US17163501100,"Census Tract 5011,St, Clair County",17,163,501100,Illinois
2733,1267,768,499,1400000US17163501200,"Census Tract 5012,St, Clair County",17,163,501200,Illinois
2734,1531,1038,493,1400000US17163501300,"Census Tract 5013,St, Clair County",17,163,501300,Illinois
2735,1041,734,307,1400000US17163501400,"Census Tract 5014,St, Clair County",17,163,501400,Illinois
2736,770,718,52,1400000US17163501501,"Census Tract 5015,01,St, Clair County",17,163,501501,Illinois
2737,1277,1144,133,1400000US17163501502,"Census Tract 5015,02,St, Clair County",17,163,501502,Illinois
2738,2413,1845,568,1400000US17163501602,"Census Tract 5016,02,St, Clair County",17,163,501602,Illinois
2739,2417,2218,199,1400000US17163501604,"Census Tract 5016,04,St, Clair County",17,163,501604,Illinois
2740,1366,1366,0,1400000US17163501605,"Census Tract 5016,05,St, Clair County",17,163,501605,Illinois
2741,1885,1512,373,1400000US17163501606,"Census Tract 5016,06,St, Clair County",17,163,501606,Illinois
2742,1057,935,122,1400000US17163501607,"Census Tract 5016,07,St, Clair County",17,163,501607,Illinois
2743,1553,1231,322,1400000US17163501700,"Census Tract 5017,St, Clair County",17,163,501700,Illinois
2744,1400,1308,92,1400000US17163501801,"Census Tract 5018,01,St, Clair County",17,163,501801,Illinois
2745,1436,990,446,1400000US17163501802,"Census Tract 5018,02,St, Clair County",17,163,501802,Illinois
2746,1687,1387,300,1400000US17163501900,"Census Tract 5019,St, Clair County",17,163,501900,Illinois
2747,917,778,139,1400000US17163502100,"Census Tract 5021,St, Clair County",17,163,502100,Illinois
2748,934,562,372,1400000US17163502200,"Census Tract 5022,St, Clair County",17,163,502200,Illinois
2749,2538,1856,682,1400000US17163502300,"Census Tract 5023,St, Clair County",17,163,502300,Illinois
2750,645,431,214,1400000US17163502401,"Census Tract 5024,01,St, Clair County",17,163,502401,Illinois
2751,1493,1247,246,1400000US17163502404,"Census Tract 5024,04,St, Clair County",17,163,502404,Illinois
2752,404,276,128,1400000US17163502500,"Census Tract 5025,St, Clair County",17,163,502500,Illinois
2753,2061,1498,563,1400000US17163502602,"Census Tract 5026,02,St, Clair County",17,163,502602,Illinois
2754,1507,1077,430,1400000US17163502603,"Census Tract 5026,03,St, Clair County",17,163,502603,Illinois
2755,501,363,138,1400000US17163502700,"Census Tract 5027,St, Clair County",17,163,502700,Illinois
2756,1182,1046,136,1400000US17163502800,"Census Tract 5028,St, Clair County",17,163,502800,Illinois
2757,1105,815,290,1400000US17163502900,"Census Tract 5029,St, Clair County",17,163,502900,Illinois
2758,948,860,88,1400000US17163503101,"Census Tract 5031,01,St, Clair County",17,163,503101,Illinois
2759,2048,1868,180,1400000US17163503102,"Census Tract 5031,02,St, Clair County",17,163,503102,Illinois
2760,2478,2269,209,1400000US17163503202,"Census Tract 5032,02,St, Clair County",17,163,503202,Illinois
2761,2682,2651,31,1400000US17163503203,"Census Tract 5032,03,St, Clair County",17,163,503203,Illinois
2762,2014,1803,211,1400000US17163503211,"Census Tract 5032,11,St, Clair County",17,163,503211,Illinois
2763,1755,1628,127,1400000US17163503301,"Census Tract 5033,01,St, Clair County",17,163,503301,Illinois
2764,2730,2607,123,1400000US17163503304,"Census Tract 5033,04,St, Clair County",17,163,503304,Illinois
2765,2837,2603,234,1400000US17163503322,"Census Tract 5033,22,St, Clair County",17,163,503322,Illinois
2766,2669,2506,163,1400000US17163503323,"Census Tract 5033,23,St, Clair County",17,163,503323,Illinois
2767,2938,2611,327,1400000US17163503324,"Census Tract 5033,24,St, Clair County",17,163,503324,Illinois
2768,2379,2278,101,1400000US17163503332,"Census Tract 5033,32,St, Clair County",17,163,503332,Illinois
2769,2774,2533,241,1400000US17163503334,"Census Tract 5033,34,St, Clair County",17,163,503334,Illinois
2770,2728,2675,53,1400000US17163503404,"Census Tract 5034,04,St, Clair County",17,163,503404,Illinois
2771,1281,1184,97,1400000US17163503411,"Census Tract 5034,11,St, Clair County",17,163,503411,Illinois
2772,2606,2290,316,1400000US17163503412,"Census Tract 5034,12,St, Clair County",17,163,503412,Illinois
2773,2840,2644,196,1400000US17163503413,"Census Tract 5034,13,St, Clair County",17,163,503413,Illinois
2774,2472,2093,379,1400000US17163503414,"Census Tract 5034,14,St, Clair County",17,163,503414,Illinois
2775,1224,1092,132,1400000US17163503415,"Census Tract 5034,15,St, Clair County",17,163,503415,Illinois
2776,2175,1701,474,1400000US17163503416,"Census Tract 5034,16,St, Clair County",17,163,503416,Illinois
2777,452,359,93,1400000US17163503800,"Census Tract 5038,St, Clair County",17,163,503800,Illinois
2778,1463,1410,53,1400000US17163503903,"Census Tract 5039,03,St, Clair County",17,163,503903,Illinois
2779,1067,1067,0,1400000US17163503905,"Census Tract 5039,05,St, Clair County",17,163,503905,Illinois
2780,2080,1978,102,1400000US17163503906,"Census Tract 5039,06,St, Clair County",17,163,503906,Illinois
2781,2298,2132,166,1400000US17163503907,"Census Tract 5039,07,St, Clair County",17,163,503907,Illinois
2782,1786,1786,0,1400000US17163503908,"Census Tract 5039,08,St, Clair County",17,163,503908,Illinois
2783,2178,2021,157,1400000US17163504001,"Census Tract 5040,01,St, Clair County",17,163,504001,Illinois
2784,2452,2063,389,1400000US17163504002,"Census Tract 5040,02,St, Clair County",17,163,504002,Illinois
2785,1318,1283,35,1400000US17163504351,"Census Tract 5043,51,St, Clair County",17,163,504351,Illinois
2786,2000,1854,146,1400000US17163504352,"Census Tract 5043,52,St, Clair County",17,163,504352,Illinois
2787,1536,1473,63,1400000US17163504353,"Census Tract 5043,53,St, Clair County",17,163,504353,Illinois
2788,2883,2654,229,1400000US17163504354,"Census Tract 5043,54,St, Clair County",17,163,504354,Illinois
2789,1867,1723,144,1400000US17163504355,"Census Tract 5043,55,St, Clair County",17,163,504355,Illinois
2790,1525,1513,12,1400000US17163504356,"Census Tract 5043,56,St, Clair County",17,163,504356,Illinois
2791,1709,1470,239,1400000US17163504357,"Census Tract 5043,57,St, Clair County",17,163,504357,Illinois
2792,1754,1498,256,1400000US17163504358,"Census Tract 5043,58,St, Clair County",17,163,504358,Illinois
2793,1657,1486,171,1400000US17163504359,"Census Tract 5043,59,St, Clair County",17,163,504359,Illinois
2794,1405,1139,266,1400000US17163504501,"Census Tract 5045,01,St, Clair County",17,163,504501,Illinois
2795,528,444,84,1400000US17163504502,"Census Tract 5045,02,St, Clair County",17,163,504502,Illinois
2796,847,618,229,1400000US17163504600,"Census Tract 5046,St, Clair County",17,163,504600,Illinois
2797,1157,1015,142,1400000US17165955100,"Census Tract 9551,Saline County",17,165,955100,Illinois
2798,1113,983,130,1400000US17165955500,"Census Tract 9555,Saline County",17,165,955500,Illinois
2799,1217,1019,198,1400000US17165955600,"Census Tract 9556,Saline County",17,165,955600,Illinois
2800,1096,988,108,1400000US17165955700,"Census Tract 9557,Saline County",17,165,955700,Illinois
2801,1603,1333,270,1400000US17165955800,"Census Tract 9558,Saline County",17,165,955800,Illinois
2802,1188,1038,150,1400000US17165955900,"Census Tract 9559,Saline County",17,165,955900,Illinois
2803,1453,1242,211,1400000US17165956000,"Census Tract 9560,Saline County",17,165,956000,Illinois
2804,1244,1022,222,1400000US17165956100,"Census Tract 9561,Saline County",17,165,956100,Illinois
2805,1522,1386,136,1400000US17165956200,"Census Tract 9562,Saline County",17,165,956200,Illinois
2806,2100,1778,322,1400000US17167000100,"Census Tract 1,Sangamon County",17,167,000100,Illinois
2807,1366,1191,175,1400000US17167000201,"Census Tract 2,01,Sangamon County",17,167,000201,Illinois
2808,1842,1483,359,1400000US17167000202,"Census Tract 2,02,Sangamon County",17,167,000202,Illinois
2809,1213,1110,103,1400000US17167000300,"Census Tract 3,Sangamon County",17,167,000300,Illinois
2810,1298,1002,296,1400000US17167000400,"Census Tract 4,Sangamon County",17,167,000400,Illinois
2811,1020,986,34,1400000US17167000501,"Census Tract 5,01,Sangamon County",17,167,000501,Illinois
2812,1780,1545,235,1400000US17167000503,"Census Tract 5,03,Sangamon County",17,167,000503,Illinois
2813,1307,1243,64,1400000US17167000504,"Census Tract 5,04,Sangamon County",17,167,000504,Illinois
2814,2286,2103,183,1400000US17167000600,"Census Tract 6,Sangamon County",17,167,000600,Illinois
2815,939,839,100,1400000US17167000700,"Census Tract 7,Sangamon County",17,167,000700,Illinois
2816,877,733,144,1400000US17167000800,"Census Tract 8,Sangamon County",17,167,000800,Illinois
2817,1421,1270,151,1400000US17167000900,"Census Tract 9,Sangamon County",17,167,000900,Illinois
2818,1002,941,61,1400000US17167001001,"Census Tract 10,01,Sangamon County",17,167,001001,Illinois
2819,778,702,76,1400000US17167001003,"Census Tract 10,03,Sangamon County",17,167,001003,Illinois
2820,2843,2711,132,1400000US17167001004,"Census Tract 10,04,Sangamon County",17,167,001004,Illinois
2821,1199,1113,86,1400000US17167001100,"Census Tract 11,Sangamon County",17,167,001100,Illinois
2822,1728,1549,179,1400000US17167001200,"Census Tract 12,Sangamon County",17,167,001200,Illinois
2823,1100,968,132,1400000US17167001300,"Census Tract 13,Sangamon County",17,167,001300,Illinois
2824,693,487,206,1400000US17167001400,"Census Tract 14,Sangamon County",17,167,001400,Illinois
2825,1729,1428,301,1400000US17167001600,"Census Tract 16,Sangamon County",17,167,001600,Illinois
2826,1307,973,334,1400000US17167001800,"Census Tract 18,Sangamon County",17,167,001800,Illinois
2827,1888,1582,306,1400000US17167001900,"Census Tract 19,Sangamon County",17,167,001900,Illinois
2828,1720,1581,139,1400000US17167002001,"Census Tract 20,01,Sangamon County",17,167,002001,Illinois
2829,1265,1211,54,1400000US17167002002,"Census Tract 20,02,Sangamon County",17,167,002002,Illinois
2830,1600,1449,151,1400000US17167002100,"Census Tract 21,Sangamon County",17,167,002100,Illinois
2831,1578,1448,130,1400000US17167002200,"Census Tract 22,Sangamon County",17,167,002200,Illinois
2832,941,829,112,1400000US17167002300,"Census Tract 23,Sangamon County",17,167,002300,Illinois
2833,1524,1353,171,1400000US17167002400,"Census Tract 24,Sangamon County",17,167,002400,Illinois
2834,2550,2305,245,1400000US17167002500,"Census Tract 25,Sangamon County",17,167,002500,Illinois
2835,1647,1579,68,1400000US17167002600,"Census Tract 26,Sangamon County",17,167,002600,Illinois
2836,1670,1467,203,1400000US17167002700,"Census Tract 27,Sangamon County",17,167,002700,Illinois
2837,1622,1415,207,1400000US17167002801,"Census Tract 28,01,Sangamon County",17,167,002801,Illinois
2838,1884,1634,250,1400000US17167002802,"Census Tract 28,02,Sangamon County",17,167,002802,Illinois
2839,2476,2331,145,1400000US17167002900,"Census Tract 29,Sangamon County",17,167,002900,Illinois
2840,2280,2035,245,1400000US17167003000,"Census Tract 30,Sangamon County",17,167,003000,Illinois
2841,3411,3305,106,1400000US17167003100,"Census Tract 31,Sangamon County",17,167,003100,Illinois
2842,1862,1824,38,1400000US17167003201,"Census Tract 32,01,Sangamon County",17,167,003201,Illinois
2843,2071,1901,170,1400000US17167003202,"Census Tract 32,02,Sangamon County",17,167,003202,Illinois
2844,2464,2400,64,1400000US17167003203,"Census Tract 32,03,Sangamon County",17,167,003203,Illinois
2845,2250,2050,200,1400000US17167003300,"Census Tract 33,Sangamon County",17,167,003300,Illinois
2846,2411,2238,173,1400000US17167003400,"Census Tract 34,Sangamon County",17,167,003400,Illinois
2847,2123,1903,220,1400000US17167003500,"Census Tract 35,Sangamon County",17,167,003500,Illinois
2848,1107,1069,38,1400000US17167003601,"Census Tract 36,01,Sangamon County",17,167,003601,Illinois
2849,2007,1868,139,1400000US17167003602,"Census Tract 36,02,Sangamon County",17,167,003602,Illinois
2850,2328,2243,85,1400000US17167003603,"Census Tract 36,03,Sangamon County",17,167,003603,Illinois
2851,2365,2310,55,1400000US17167003604,"Census Tract 36,04,Sangamon County",17,167,003604,Illinois
2852,1474,1452,22,1400000US17167003701,"Census Tract 37,01,Sangamon County",17,167,003701,Illinois
2853,1686,1679,7,1400000US17167003702,"Census Tract 37,02,Sangamon County",17,167,003702,Illinois
2854,1102,1092,10,1400000US17167003801,"Census Tract 38,01,Sangamon County",17,167,003801,Illinois
2855,2866,2751,115,1400000US17167003802,"Census Tract 38,02,Sangamon County",17,167,003802,Illinois
2856,2068,1992,76,1400000US17167003901,"Census Tract 39,01,Sangamon County",17,167,003901,Illinois
2857,1770,1659,111,1400000US17167003902,"Census Tract 39,02,Sangamon County",17,167,003902,Illinois
2858,1930,1802,128,1400000US17167004000,"Census Tract 40,Sangamon County",17,167,004000,Illinois
2859,934,718,216,1400000US17167004200,"Census Tract 42,Sangamon County",17,167,004200,Illinois
2860,913,722,191,1400000US17169970100,"Census Tract 9701,Schuyler County",17,169,970100,Illinois
2861,1492,1212,280,1400000US17169970200,"Census Tract 9702,Schuyler County",17,169,970200,Illinois
2862,937,758,179,1400000US17169970300,"Census Tract 9703,Schuyler County",17,169,970300,Illinois
2863,870,677,193,1400000US17171970600,"Census Tract 9706,Scott County",17,171,970600,Illinois
2864,1533,1266,267,1400000US17171970700,"Census Tract 9707,Scott County",17,171,970700,Illinois
2865,1541,1353,188,1400000US17173959100,"Census Tract 9591,Shelby County",17,173,959100,Illinois
2866,1511,1173,338,1400000US17173959200,"Census Tract 9592,Shelby County",17,173,959200,Illinois
2867,2492,2202,290,1400000US17173959300,"Census Tract 9593,Shelby County",17,173,959300,Illinois
2868,1537,1356,181,1400000US17173959400,"Census Tract 9594,Shelby County",17,173,959400,Illinois
2869,1578,1430,148,1400000US17173959500,"Census Tract 9595,Shelby County",17,173,959500,Illinois
2870,1416,1254,162,1400000US17173959600,"Census Tract 9596,Shelby County",17,173,959600,Illinois
2871,1446,1243,203,1400000US17175951400,"Census Tract 9514,Stark County",17,175,951400,Illinois
2872,1142,1019,123,1400000US17175951500,"Census Tract 9515,Stark County",17,175,951500,Illinois
2873,1991,1691,300,1400000US17177000100,"Census Tract 1,Stephenson County",17,177,000100,Illinois
2874,1548,1263,285,1400000US17177000200,"Census Tract 2,Stephenson County",17,177,000200,Illinois
2875,1751,1590,161,1400000US17177000300,"Census Tract 3,Stephenson County",17,177,000300,Illinois
2876,1088,1049,39,1400000US17177000400,"Census Tract 4,Stephenson County",17,177,000400,Illinois
2877,1423,1320,103,1400000US17177000500,"Census Tract 5,Stephenson County",17,177,000500,Illinois
2878,1438,1346,92,1400000US17177000600,"Census Tract 6,Stephenson County",17,177,000600,Illinois
2879,978,889,89,1400000US17177000700,"Census Tract 7,Stephenson County",17,177,000700,Illinois
2880,1716,1333,383,1400000US17177000800,"Census Tract 8,Stephenson County",17,177,000800,Illinois
2881,2353,2183,170,1400000US17177000900,"Census Tract 9,Stephenson County",17,177,000900,Illinois
2882,1990,1881,109,1400000US17177001000,"Census Tract 10,Stephenson County",17,177,001000,Illinois
2883,1583,1508,75,1400000US17177001100,"Census Tract 11,Stephenson County",17,177,001100,Illinois
2884,1764,1574,190,1400000US17177001200,"Census Tract 12,Stephenson County",17,177,001200,Illinois
2885,1826,1626,200,1400000US17177001300,"Census Tract 13,Stephenson County",17,177,001300,Illinois
2886,1431,1231,200,1400000US17179020100,"Census Tract 201,Tazewell County",17,179,020100,Illinois
2887,1845,1625,220,1400000US17179020301,"Census Tract 203,01,Tazewell County",17,179,020301,Illinois
2888,2122,1783,339,1400000US17179020302,"Census Tract 203,02,Tazewell County",17,179,020302,Illinois
2889,2363,2210,153,1400000US17179020400,"Census Tract 204,Tazewell County",17,179,020400,Illinois
2890,2006,1873,133,1400000US17179020500,"Census Tract 205,Tazewell County",17,179,020500,Illinois
2891,1003,941,62,1400000US17179020600,"Census Tract 206,Tazewell County",17,179,020600,Illinois
2892,2193,2002,191,1400000US17179020700,"Census Tract 207,Tazewell County",17,179,020700,Illinois
2893,1488,1267,221,1400000US17179020800,"Census Tract 208,Tazewell County",17,179,020800,Illinois
2894,897,731,166,1400000US17179020900,"Census Tract 209,Tazewell County",17,179,020900,Illinois
2895,2713,2512,201,1400000US17179021000,"Census Tract 210,Tazewell County",17,179,021000,Illinois
2896,3321,2992,329,1400000US17179021101,"Census Tract 211,01,Tazewell County",17,179,021101,Illinois
2897,2461,2319,142,1400000US17179021102,"Census Tract 211,02,Tazewell County",17,179,021102,Illinois
2898,2154,1999,155,1400000US17179021201,"Census Tract 212,01,Tazewell County",17,179,021201,Illinois
2899,1573,1423,150,1400000US17179021202,"Census Tract 212,02,Tazewell County",17,179,021202,Illinois
2900,2353,2223,130,1400000US17179021203,"Census Tract 212,03,Tazewell County",17,179,021203,Illinois
2901,3069,2782,287,1400000US17179021500,"Census Tract 215,Tazewell County",17,179,021500,Illinois
2902,2352,2206,146,1400000US17179021603,"Census Tract 216,03,Tazewell County",17,179,021603,Illinois
2903,1044,974,70,1400000US17179021604,"Census Tract 216,04,Tazewell County",17,179,021604,Illinois
2904,1226,1193,33,1400000US17179021605,"Census Tract 216,05,Tazewell County",17,179,021605,Illinois
2905,2473,2328,145,1400000US17179021606,"Census Tract 216,06,Tazewell County",17,179,021606,Illinois
2906,2503,2351,152,1400000US17179021701,"Census Tract 217,01,Tazewell County",17,179,021701,Illinois
2907,2341,2150,191,1400000US17179021702,"Census Tract 217,02,Tazewell County",17,179,021702,Illinois
2908,1634,1530,104,1400000US17179021801,"Census Tract 218,01,Tazewell County",17,179,021801,Illinois
2909,913,714,199,1400000US17179021802,"Census Tract 218,02,Tazewell County",17,179,021802,Illinois
2910,1943,1705,238,1400000US17179021900,"Census Tract 219,Tazewell County",17,179,021900,Illinois
2911,1769,1637,132,1400000US17179022000,"Census Tract 220,Tazewell County",17,179,022000,Illinois
2912,1519,1435,84,1400000US17179022100,"Census Tract 221,Tazewell County",17,179,022100,Illinois
2913,1827,1668,159,1400000US17179022200,"Census Tract 222,Tazewell County",17,179,022200,Illinois
2914,2023,2013,10,1400000US17179022300,"Census Tract 223,Tazewell County",17,179,022300,Illinois
2915,2047,1902,145,1400000US17179022400,"Census Tract 224,Tazewell County",17,179,022400,Illinois
2916,1998,1784,214,1400000US17181950100,"Census Tract 9501,Union County",17,181,950100,Illinois
2917,1060,837,223,1400000US17181950200,"Census Tract 9502,Union County",17,181,950200,Illinois
2918,887,787,100,1400000US17181950300,"Census Tract 9503,Union County",17,181,950300,Illinois
2919,2375,2043,332,1400000US17181950400,"Census Tract 9504,Union County",17,181,950400,Illinois
2920,1540,1251,289,1400000US17181950500,"Census Tract 9505,Union County",17,181,950500,Illinois
2921,927,661,266,1400000US17183000100,"Census Tract 1,Vermilion County",17,183,000100,Illinois
2922,734,588,146,1400000US17183000200,"Census Tract 2,Vermilion County",17,183,000200,Illinois
2923,895,750,145,1400000US17183000300,"Census Tract 3,Vermilion County",17,183,000300,Illinois
2924,1345,1017,328,1400000US17183000400,"Census Tract 4,Vermilion County",17,183,000400,Illinois
2925,1811,1570,241,1400000US17183000500,"Census Tract 5,Vermilion County",17,183,000500,Illinois
2926,1107,789,318,1400000US17183000600,"Census Tract 6,Vermilion County",17,183,000600,Illinois
2927,1725,1580,145,1400000US17183000700,"Census Tract 7,Vermilion County",17,183,000700,Illinois
2928,1115,813,302,1400000US17183000800,"Census Tract 8,Vermilion County",17,183,000800,Illinois
2929,1057,835,222,1400000US17183000900,"Census Tract 9,Vermilion County",17,183,000900,Illinois
2930,1655,1556,99,1400000US17183001200,"Census Tract 12,Vermilion County",17,183,001200,Illinois
2931,1998,1745,253,1400000US17183001300,"Census Tract 13,Vermilion County",17,183,001300,Illinois
2932,1328,1148,180,1400000US17183010100,"Census Tract 101,Vermilion County",17,183,010100,Illinois
2933,2561,2079,482,1400000US17183010200,"Census Tract 102,Vermilion County",17,183,010200,Illinois
2934,1903,1689,214,1400000US17183010300,"Census Tract 103,Vermilion County",17,183,010300,Illinois
2935,891,830,61,1400000US17183010400,"Census Tract 104,Vermilion County",17,183,010400,Illinois
2936,1692,1386,306,1400000US17183010500,"Census Tract 105,Vermilion County",17,183,010500,Illinois
2937,1793,1672,121,1400000US17183010600,"Census Tract 106,Vermilion County",17,183,010600,Illinois
2938,1277,1277,0,1400000US17183010701,"Census Tract 107,01,Vermilion County",17,183,010701,Illinois
2939,1271,1223,48,1400000US17183010702,"Census Tract 107,02,Vermilion County",17,183,010702,Illinois
2940,1439,1284,155,1400000US17183010800,"Census Tract 108,Vermilion County",17,183,010800,Illinois
2941,1213,1091,122,1400000US17183010900,"Census Tract 109,Vermilion County",17,183,010900,Illinois
2942,1978,1738,240,1400000US17183011000,"Census Tract 110,Vermilion County",17,183,011000,Illinois
2943,1096,996,100,1400000US17183011100,"Census Tract 111,Vermilion County",17,183,011100,Illinois
2944,1815,1430,385,1400000US17183011200,"Census Tract 112,Vermilion County",17,183,011200,Illinois
2945,1687,1462,225,1400000US17185957200,"Census Tract 9572,Wabash County",17,185,957200,Illinois
2946,1481,1423,58,1400000US17185957300,"Census Tract 9573,Wabash County",17,185,957300,Illinois
2947,968,807,161,1400000US17185957400,"Census Tract 9574,Wabash County",17,185,957400,Illinois
2948,1282,1039,243,1400000US17185957500,"Census Tract 9575,Wabash County",17,185,957500,Illinois
2949,1169,991,178,1400000US17187870100,"Census Tract 8701,Warren County",17,187,870100,Illinois
2950,1133,1008,125,1400000US17187870200,"Census Tract 8702,Warren County",17,187,870200,Illinois
2951,1231,1152,79,1400000US17187870300,"Census Tract 8703,Warren County",17,187,870300,Illinois
2952,2018,1880,138,1400000US17187870400,"Census Tract 8704,Warren County",17,187,870400,Illinois
2953,2062,1787,275,1400000US17187870500,"Census Tract 8705,Warren County",17,187,870500,Illinois
2954,1400,1290,110,1400000US17189950100,"Census Tract 9501,Washington County",17,189,950100,Illinois
2955,1711,1504,207,1400000US17189950200,"Census Tract 9502,Washington County",17,189,950200,Illinois
2956,1369,1308,61,1400000US17189950300,"Census Tract 9503,Washington County",17,189,950300,Illinois
2957,1948,1709,239,1400000US17189950400,"Census Tract 9504,Washington County",17,189,950400,Illinois
2958,1598,1373,225,1400000US17191954900,"Census Tract 9549,Wayne County",17,191,954900,Illinois
2959,1810,1618,192,1400000US17191955000,"Census Tract 9550,Wayne County",17,191,955000,Illinois
2960,1536,1361,175,1400000US17191955100,"Census Tract 9551,Wayne County",17,191,955100,Illinois
2961,1488,1319,169,1400000US17191955200,"Census Tract 9552,Wayne County",17,191,955200,Illinois
2962,1275,1125,150,1400000US17191955300,"Census Tract 9553,Wayne County",17,191,955300,Illinois
2963,1165,854,311,1400000US17193958000,"Census Tract 9580,White County",17,193,958000,Illinois
2964,1668,1537,131,1400000US17193958100,"Census Tract 9581,White County",17,193,958100,Illinois
2965,1352,1185,167,1400000US17193958200,"Census Tract 9582,White County",17,193,958200,Illinois
2966,1240,1068,172,1400000US17193958300,"Census Tract 9583,White County",17,193,958300,Illinois
2967,1380,1046,334,1400000US17193958400,"Census Tract 9584,White County",17,193,958400,Illinois
2968,1519,1375,144,1400000US17195000100,"Census Tract 1,Whiteside County",17,195,000100,Illinois
2969,1324,1264,60,1400000US17195000200,"Census Tract 2,Whiteside County",17,195,000200,Illinois
2970,1422,1197,225,1400000US17195000300,"Census Tract 3,Whiteside County",17,195,000300,Illinois
2971,1482,1282,200,1400000US17195000400,"Census Tract 4,Whiteside County",17,195,000400,Illinois
2972,1760,1626,134,1400000US17195000500,"Census Tract 5,Whiteside County",17,195,000500,Illinois
2973,1903,1700,203,1400000US17195000600,"Census Tract 6,Whiteside County",17,195,000600,Illinois
2974,1175,1019,156,1400000US17195000700,"Census Tract 7,Whiteside County",17,195,000700,Illinois
2975,929,821,108,1400000US17195000800,"Census Tract 8,Whiteside County",17,195,000800,Illinois
2976,1649,1481,168,1400000US17195000900,"Census Tract 9,Whiteside County",17,195,000900,Illinois
2977,1257,1026,231,1400000US17195001000,"Census Tract 10,Whiteside County",17,195,001000,Illinois
2978,1194,1194,0,1400000US17195001101,"Census Tract 11,01,Whiteside County",17,195,001101,Illinois
2979,971,822,149,1400000US17195001102,"Census Tract 11,02,Whiteside County",17,195,001102,Illinois
2980,1855,1685,170,1400000US17195001200,"Census Tract 12,Whiteside County",17,195,001200,Illinois
2981,1273,1182,91,1400000US17195001300,"Census Tract 13,Whiteside County",17,195,001300,Illinois
2982,1006,873,133,1400000US17195001400,"Census Tract 14,Whiteside County",17,195,001400,Illinois
2983,1661,1500,161,1400000US17195001500,"Census Tract 15,Whiteside County",17,195,001500,Illinois
2984,1128,1026,102,1400000US17195001600,"Census Tract 16,Whiteside County",17,195,001600,Illinois
2985,1493,1301,192,1400000US17195001700,"Census Tract 17,Whiteside County",17,195,001700,Illinois
2986,871,820,51,1400000US17195001800,"Census Tract 18,Whiteside County",17,195,001800,Illinois
2987,2095,2095,0,1400000US17197880105,"Census Tract 8801,05,Will County",17,197,880105,Illinois
2988,1609,1547,62,1400000US17197880106,"Census Tract 8801,06,Will County",17,197,880106,Illinois
2989,1524,1502,22,1400000US17197880107,"Census Tract 8801,07,Will County",17,197,880107,Illinois
2990,1893,1828,65,1400000US17197880109,"Census Tract 8801,09,Will County",17,197,880109,Illinois
2991,1209,1146,63,1400000US17197880111,"Census Tract 8801,11,Will County",17,197,880111,Illinois
2992,613,593,20,1400000US17197880112,"Census Tract 8801,12,Will County",17,197,880112,Illinois
2993,1184,1128,56,1400000US17197880113,"Census Tract 8801,13,Will County",17,197,880113,Illinois
2994,1006,920,86,1400000US17197880114,"Census Tract 8801,14,Will County",17,197,880114,Illinois
2995,1410,1304,106,1400000US17197880115,"Census Tract 8801,15,Will County",17,197,880115,Illinois
2996,1016,986,30,1400000US17197880116,"Census Tract 8801,16,Will County",17,197,880116,Illinois
2997,1675,1568,107,1400000US17197880117,"Census Tract 8801,17,Will County",17,197,880117,Illinois
2998,1677,1649,28,1400000US17197880118,"Census Tract 8801,18,Will County",17,197,880118,Illinois
2999,1513,1474,39,1400000US17197880119,"Census Tract 8801,19,Will County",17,197,880119,Illinois
3000,2109,2070,39,1400000US17197880122,"Census Tract 8801,22,Will County",17,197,880122,Illinois
3001,1292,1292,0,1400000US17197880123,"Census Tract 8801,23,Will County",17,197,880123,Illinois
3002,992,954,38,1400000US17197880124,"Census Tract 8801,24,Will County",17,197,880124,Illinois
3003,1423,1423,0,1400000US17197880125,"Census Tract 8801,25,Will County",17,197,880125,Illinois
3004,1633,1580,53,1400000US17197880202,"Census Tract 8802,02,Will County",17,197,880202,Illinois
3005,1141,1122,19,1400000US17197880203,"Census Tract 8802,03,Will County",17,197,880203,Illinois
3006,2474,2286,188,1400000US17197880204,"Census Tract 8802,04,Will County",17,197,880204,Illinois
3007,1492,1471,21,1400000US17197880303,"Census Tract 8803,03,Will County",17,197,880303,Illinois
3008,1561,1544,17,1400000US17197880304,"Census Tract 8803,04,Will County",17,197,880304,Illinois
3009,1704,1686,18,1400000US17197880305,"Census Tract 8803,05,Will County",17,197,880305,Illinois
3010,2380,2262,118,1400000US17197880307,"Census Tract 8803,07,Will County",17,197,880307,Illinois
3011,1473,1473,0,1400000US17197880309,"Census Tract 8803,09,Will County",17,197,880309,Illinois
3012,1988,1977,11,1400000US17197880314,"Census Tract 8803,14,Will County",17,197,880314,Illinois
3013,1167,1167,0,1400000US17197880315,"Census Tract 8803,15,Will County",17,197,880315,Illinois
3014,1250,1172,78,1400000US17197880316,"Census Tract 8803,16,Will County",17,197,880316,Illinois
3015,1941,1892,49,1400000US17197880317,"Census Tract 8803,17,Will County",17,197,880317,Illinois
3016,1156,1119,37,1400000US17197880318,"Census Tract 8803,18,Will County",17,197,880318,Illinois
3017,1430,1430,0,1400000US17197880319,"Census Tract 8803,19,Will County",17,197,880319,Illinois
3018,1007,1007,0,1400000US17197880320,"Census Tract 8803,20,Will County",17,197,880320,Illinois
3019,1491,1491,0,1400000US17197880321,"Census Tract 8803,21,Will County",17,197,880321,Illinois
3020,1893,1803,90,1400000US17197880322,"Census Tract 8803,22,Will County",17,197,880322,Illinois
3021,2689,2517,172,1400000US17197880323,"Census Tract 8803,23,Will County",17,197,880323,Illinois
3022,1614,1584,30,1400000US17197880324,"Census Tract 8803,24,Will County",17,197,880324,Illinois
3023,1174,1174,0,1400000US17197880325,"Census Tract 8803,25,Will County",17,197,880325,Illinois
3024,990,974,16,1400000US17197880326,"Census Tract 8803,26,Will County",17,197,880326,Illinois
3025,1702,1702,0,1400000US17197880408,"Census Tract 8804,08,Will County",17,197,880408,Illinois
3026,1235,1181,54,1400000US17197880411,"Census Tract 8804,11,Will County",17,197,880411,Illinois
3027,1480,1443,37,1400000US17197880412,"Census Tract 8804,12,Will County",17,197,880412,Illinois
3028,1639,1576,63,1400000US17197880414,"Census Tract 8804,14,Will County",17,197,880414,Illinois
3029,913,913,0,1400000US17197880416,"Census Tract 8804,16,Will County",17,197,880416,Illinois
3030,987,974,13,1400000US17197880417,"Census Tract 8804,17,Will County",17,197,880417,Illinois
3031,1582,1529,53,1400000US17197880418,"Census Tract 8804,18,Will County",17,197,880418,Illinois
3032,1945,1896,49,1400000US17197880421,"Census Tract 8804,21,Will County",17,197,880421,Illinois
3033,1407,1407,0,1400000US17197880422,"Census Tract 8804,22,Will County",17,197,880422,Illinois
3034,1295,1098,197,1400000US17197880423,"Census Tract 8804,23,Will County",17,197,880423,Illinois
3035,1254,1254,0,1400000US17197880424,"Census Tract 8804,24,Will County",17,197,880424,Illinois
3036,1180,1109,71,1400000US17197880425,"Census Tract 8804,25,Will County",17,197,880425,Illinois
3037,1213,1213,0,1400000US17197880426,"Census Tract 8804,26,Will County",17,197,880426,Illinois
3038,1072,1072,0,1400000US17197880427,"Census Tract 8804,27,Will County",17,197,880427,Illinois
3039,1421,1421,0,1400000US17197880428,"Census Tract 8804,28,Will County",17,197,880428,Illinois
3040,1431,1431,0,1400000US17197880429,"Census Tract 8804,29,Will County",17,197,880429,Illinois
3041,1088,1052,36,1400000US17197880430,"Census Tract 8804,30,Will County",17,197,880430,Illinois
3042,1888,1798,90,1400000US17197880431,"Census Tract 8804,31,Will County",17,197,880431,Illinois
3043,1119,1119,0,1400000US17197880432,"Census Tract 8804,32,Will County",17,197,880432,Illinois
3044,1847,1820,27,1400000US17197880502,"Census Tract 8805,02,Will County",17,197,880502,Illinois
3045,2135,2135,0,1400000US17197880503,"Census Tract 8805,03,Will County",17,197,880503,Illinois
3046,1125,990,135,1400000US17197880508,"Census Tract 8805,08,Will County",17,197,880508,Illinois
3047,1370,1286,84,1400000US17197880509,"Census Tract 8805,09,Will County",17,197,880509,Illinois
3048,1089,1038,51,1400000US17197880510,"Census Tract 8805,10,Will County",17,197,880510,Illinois
3049,1024,1024,0,1400000US17197880511,"Census Tract 8805,11,Will County",17,197,880511,Illinois
3050,1152,1131,21,1400000US17197880601,"Census Tract 8806,01,Will County",17,197,880601,Illinois
3051,1739,1460,279,1400000US17197880602,"Census Tract 8806,02,Will County",17,197,880602,Illinois
3052,1762,1707,55,1400000US17197880701,"Census Tract 8807,01,Will County",17,197,880701,Illinois
3053,1027,866,161,1400000US17197880702,"Census Tract 8807,02,Will County",17,197,880702,Illinois
3054,2692,2639,53,1400000US17197880901,"Census Tract 8809,01,Will County",17,197,880901,Illinois
3055,1581,1521,60,1400000US17197880903,"Census Tract 8809,03,Will County",17,197,880903,Illinois
3056,1238,1177,61,1400000US17197880905,"Census Tract 8809,05,Will County",17,197,880905,Illinois
3057,1816,1759,57,1400000US17197881001,"Census Tract 8810,01,Will County",17,197,881001,Illinois
3058,1748,1684,64,1400000US17197881002,"Census Tract 8810,02,Will County",17,197,881002,Illinois
3059,1185,1112,73,1400000US17197881005,"Census Tract 8810,05,Will County",17,197,881005,Illinois
3060,896,850,46,1400000US17197881006,"Census Tract 8810,06,Will County",17,197,881006,Illinois
3061,1960,1907,53,1400000US17197881007,"Census Tract 8810,07,Will County",17,197,881007,Illinois
3062,2652,2566,86,1400000US17197881009,"Census Tract 8810,09,Will County",17,197,881009,Illinois
3063,1355,1355,0,1400000US17197881010,"Census Tract 8810,10,Will County",17,197,881010,Illinois
3064,1281,1245,36,1400000US17197881011,"Census Tract 8810,11,Will County",17,197,881011,Illinois
3065,881,881,0,1400000US17197881012,"Census Tract 8810,12,Will County",17,197,881012,Illinois
3066,2495,2398,97,1400000US17197881105,"Census Tract 8811,05,Will County",17,197,881105,Illinois
3067,1050,966,84,1400000US17197881107,"Census Tract 8811,07,Will County",17,197,881107,Illinois
3068,2599,2353,246,1400000US17197881108,"Census Tract 8811,08,Will County",17,197,881108,Illinois
3069,1479,1434,45,1400000US17197881109,"Census Tract 8811,09,Will County",17,197,881109,Illinois
3070,1266,1132,134,1400000US17197881111,"Census Tract 8811,11,Will County",17,197,881111,Illinois
3071,1765,1706,59,1400000US17197881112,"Census Tract 8811,12,Will County",17,197,881112,Illinois
3072,1977,1911,66,1400000US17197881113,"Census Tract 8811,13,Will County",17,197,881113,Illinois
3073,1649,1626,23,1400000US17197881115,"Census Tract 8811,15,Will County",17,197,881115,Illinois
3074,1339,1339,0,1400000US17197881116,"Census Tract 8811,16,Will County",17,197,881116,Illinois
3075,974,888,86,1400000US17197881201,"Census Tract 8812,01,Will County",17,197,881201,Illinois
3076,830,716,114,1400000US17197881202,"Census Tract 8812,02,Will County",17,197,881202,Illinois
3077,989,926,63,1400000US17197881301,"Census Tract 8813,01,Will County",17,197,881301,Illinois
3078,352,305,47,1400000US17197881302,"Census Tract 8813,02,Will County",17,197,881302,Illinois
3079,1370,1278,92,1400000US17197881401,"Census Tract 8814,01,Will County",17,197,881401,Illinois
3080,1360,1360,0,1400000US17197881402,"Census Tract 8814,02,Will County",17,197,881402,Illinois
3081,1228,1158,70,1400000US17197881500,"Census Tract 8815,Will County",17,197,881500,Illinois
3082,917,902,15,1400000US17197881601,"Census Tract 8816,01,Will County",17,197,881601,Illinois
3083,1608,1456,152,1400000US17197881603,"Census Tract 8816,03,Will County",17,197,881603,Illinois
3084,1180,1137,43,1400000US17197881604,"Census Tract 8816,04,Will County",17,197,881604,Illinois
3085,1363,1297,66,1400000US17197881700,"Census Tract 8817,Will County",17,197,881700,Illinois
3086,1501,1440,61,1400000US17197881800,"Census Tract 8818,Will County",17,197,881800,Illinois
3087,1803,1542,261,1400000US17197881900,"Census Tract 8819,Will County",17,197,881900,Illinois
3088,995,668,327,1400000US17197882000,"Census Tract 8820,Will County",17,197,882000,Illinois
3089,882,810,72,1400000US17197882100,"Census Tract 8821,Will County",17,197,882100,Illinois
3090,1445,1300,145,1400000US17197882200,"Census Tract 8822,Will County",17,197,882200,Illinois
3091,1444,1346,98,1400000US17197882300,"Census Tract 8823,Will County",17,197,882300,Illinois
3092,1236,1163,73,1400000US17197882400,"Census Tract 8824,Will County",17,197,882400,Illinois
3093,665,587,78,1400000US17197882500,"Census Tract 8825,Will County",17,197,882500,Illinois
3094,1184,1158,26,1400000US17197882601,"Census Tract 8826,01,Will County",17,197,882601,Illinois
3095,1013,865,148,1400000US17197882602,"Census Tract 8826,02,Will County",17,197,882602,Illinois
3096,992,957,35,1400000US17197882701,"Census Tract 8827,01,Will County",17,197,882701,Illinois
3097,1248,1180,68,1400000US17197882702,"Census Tract 8827,02,Will County",17,197,882702,Illinois
3098,1138,1005,133,1400000US17197882801,"Census Tract 8828,01,Will County",17,197,882801,Illinois
3099,1272,1125,147,1400000US17197882802,"Census Tract 8828,02,Will County",17,197,882802,Illinois
3100,1092,975,117,1400000US17197882900,"Census Tract 8829,Will County",17,197,882900,Illinois
3101,1102,989,113,1400000US17197883000,"Census Tract 8830,Will County",17,197,883000,Illinois
3102,1565,1447,118,1400000US17197883100,"Census Tract 8831,Will County",17,197,883100,Illinois
3103,1946,1799,147,1400000US17197883206,"Census Tract 8832,06,Will County",17,197,883206,Illinois
3104,1462,1402,60,1400000US17197883208,"Census Tract 8832,08,Will County",17,197,883208,Illinois
3105,1154,1108,46,1400000US17197883209,"Census Tract 8832,09,Will County",17,197,883209,Illinois
3106,1454,1443,11,1400000US17197883210,"Census Tract 8832,10,Will County",17,197,883210,Illinois
3107,2216,1910,306,1400000US17197883211,"Census Tract 8832,11,Will County",17,197,883211,Illinois
3108,2090,2070,20,1400000US17197883212,"Census Tract 8832,12,Will County",17,197,883212,Illinois
3109,2557,2395,162,1400000US17197883213,"Census Tract 8832,13,Will County",17,197,883213,Illinois
3110,965,933,32,1400000US17197883214,"Census Tract 8832,14,Will County",17,197,883214,Illinois
3111,1212,1120,92,1400000US17197883216,"Census Tract 8832,16,Will County",17,197,883216,Illinois
3112,1118,1118,0,1400000US17197883217,"Census Tract 8832,17,Will County",17,197,883217,Illinois
3113,1239,1239,0,1400000US17197883218,"Census Tract 8832,18,Will County",17,197,883218,Illinois
3114,1118,1078,40,1400000US17197883219,"Census Tract 8832,19,Will County",17,197,883219,Illinois
3115,1291,1254,37,1400000US17197883303,"Census Tract 8833,03,Will County",17,197,883303,Illinois
3116,760,680,80,1400000US17197883304,"Census Tract 8833,04,Will County",17,197,883304,Illinois
3117,1142,1142,0,1400000US17197883305,"Census Tract 8833,05,Will County",17,197,883305,Illinois
3118,1127,1099,28,1400000US17197883306,"Census Tract 8833,06,Will County",17,197,883306,Illinois
3119,1693,1589,104,1400000US17197883307,"Census Tract 8833,07,Will County",17,197,883307,Illinois
3120,1858,1710,148,1400000US17197883401,"Census Tract 8834,01,Will County",17,197,883401,Illinois
3121,987,850,137,1400000US17197883402,"Census Tract 8834,02,Will County",17,197,883402,Illinois
3122,2251,2194,57,1400000US17197883504,"Census Tract 8835,04,Will County",17,197,883504,Illinois
3123,2780,2613,167,1400000US17197883505,"Census Tract 8835,05,Will County",17,197,883505,Illinois
3124,1447,1412,35,1400000US17197883507,"Census Tract 8835,07,Will County",17,197,883507,Illinois
3125,1938,1858,80,1400000US17197883509,"Census Tract 8835,09,Will County",17,197,883509,Illinois
3126,2163,2048,115,1400000US17197883510,"Census Tract 8835,10,Will County",17,197,883510,Illinois
3127,1678,1629,49,1400000US17197883511,"Census Tract 8835,11,Will County",17,197,883511,Illinois
3128,1878,1741,137,1400000US17197883513,"Census Tract 8835,13,Will County",17,197,883513,Illinois
3129,2497,2349,148,1400000US17197883514,"Census Tract 8835,14,Will County",17,197,883514,Illinois
3130,1656,1627,29,1400000US17197883515,"Census Tract 8835,15,Will County",17,197,883515,Illinois
3131,2435,2332,103,1400000US17197883516,"Census Tract 8835,16,Will County",17,197,883516,Illinois
3132,1289,1253,36,1400000US17197883517,"Census Tract 8835,17,Will County",17,197,883517,Illinois
3133,2348,2222,126,1400000US17197883519,"Census Tract 8835,19,Will County",17,197,883519,Illinois
3134,1252,1252,0,1400000US17197883521,"Census Tract 8835,21,Will County",17,197,883521,Illinois
3135,1170,1137,33,1400000US17197883522,"Census Tract 8835,22,Will County",17,197,883522,Illinois
3136,2619,2535,84,1400000US17197883602,"Census Tract 8836,02,Will County",17,197,883602,Illinois
3137,1099,867,232,1400000US17197883603,"Census Tract 8836,03,Will County",17,197,883603,Illinois
3138,1413,1209,204,1400000US17197883605,"Census Tract 8836,05,Will County",17,197,883605,Illinois
3139,1342,1255,87,1400000US17197883606,"Census Tract 8836,06,Will County",17,197,883606,Illinois
3140,1752,1603,149,1400000US17197883700,"Census Tract 8837,Will County",17,197,883700,Illinois
3141,1311,1187,124,1400000US17197883803,"Census Tract 8838,03,Will County",17,197,883803,Illinois
3142,1070,1024,46,1400000US17197883804,"Census Tract 8838,04,Will County",17,197,883804,Illinois
3143,1363,1308,55,1400000US17197883806,"Census Tract 8838,06,Will County",17,197,883806,Illinois
3144,636,587,49,1400000US17197883808,"Census Tract 8838,08,Will County",17,197,883808,Illinois
3145,1663,1555,108,1400000US17197883809,"Census Tract 8838,09,Will County",17,197,883809,Illinois
3146,1536,1391,145,1400000US17197883810,"Census Tract 8838,10,Will County",17,197,883810,Illinois
3147,1331,1198,133,1400000US17197883811,"Census Tract 8838,11,Will County",17,197,883811,Illinois
3148,2491,2302,189,1400000US17197883902,"Census Tract 8839,02,Will County",17,197,883902,Illinois
3149,753,693,60,1400000US17197883903,"Census Tract 8839,03,Will County",17,197,883903,Illinois
3150,1798,1770,28,1400000US17197883904,"Census Tract 8839,04,Will County",17,197,883904,Illinois
3151,1563,1533,30,1400000US17197884003,"Census Tract 8840,03,Will County",17,197,884003,Illinois
3152,1633,1221,412,1400000US17197884004,"Census Tract 8840,04,Will County",17,197,884004,Illinois
3153,606,536,70,1400000US17197884005,"Census Tract 8840,05,Will County",17,197,884005,Illinois
3154,875,765,110,1400000US17197884006,"Census Tract 8840,06,Will County",17,197,884006,Illinois
3155,1796,1596,200,1400000US17197884101,"Census Tract 8841,01,Will County",17,197,884101,Illinois
3156,885,885,0,1400000US17197884103,"Census Tract 8841,03,Will County",17,197,884103,Illinois
3157,0,0,0,1400000US17197980000,"Census Tract 9800,Will County",17,197,980000,Illinois
3158,34,21,13,1400000US17197980100,"Census Tract 9801,Will County",17,197,980100,Illinois
3159,1760,1548,212,1400000US17199020100,"Census Tract 201,Williamson County",17,199,020100,Illinois
3160,2686,2493,193,1400000US17199020201,"Census Tract 202,01,Williamson County",17,199,020201,Illinois
3161,1177,1005,172,1400000US17199020202,"Census Tract 202,02,Williamson County",17,199,020202,Illinois
3162,2421,2196,225,1400000US17199020300,"Census Tract 203,Williamson County",17,199,020300,Illinois
3163,2026,1701,325,1400000US17199020400,"Census Tract 204,Williamson County",17,199,020400,Illinois
3164,1658,1541,117,1400000US17199020500,"Census Tract 205,Williamson County",17,199,020500,Illinois
3165,1509,1324,185,1400000US17199020600,"Census Tract 206,Williamson County",17,199,020600,Illinois
3166,1906,1799,107,1400000US17199020700,"Census Tract 207,Williamson County",17,199,020700,Illinois
3167,1145,1048,97,1400000US17199020801,"Census Tract 208,01,Williamson County",17,199,020801,Illinois
3168,1994,1550,444,1400000US17199020802,"Census Tract 208,02,Williamson County",17,199,020802,Illinois
3169,2421,2320,101,1400000US17199020900,"Census Tract 209,Williamson County",17,199,020900,Illinois
3170,1330,1193,137,1400000US17199021001,"Census Tract 210,01,Williamson County",17,199,021001,Illinois
3171,829,687,142,1400000US17199021002,"Census Tract 210,02,Williamson County",17,199,021002,Illinois
3172,595,542,53,1400000US17199021003,"Census Tract 210,03,Williamson County",17,199,021003,Illinois
3173,1627,1335,292,1400000US17199021100,"Census Tract 211,Williamson County",17,199,021100,Illinois
3174,2123,1898,225,1400000US17199021200,"Census Tract 212,Williamson County",17,199,021200,Illinois
3175,2273,2122,151,1400000US17199021300,"Census Tract 213,Williamson County",17,199,021300,Illinois
3176,2194,1755,439,1400000US17199021400,"Census Tract 214,Williamson County",17,199,021400,Illinois
3177,1786,1736,50,1400000US17201000101,"Census Tract 1,01,Winnebago County",17,201,000101,Illinois
3178,1070,1005,65,1400000US17201000103,"Census Tract 1,03,Winnebago County",17,201,000103,Illinois
3179,1243,1060,183,1400000US17201000104,"Census Tract 1,04,Winnebago County",17,201,000104,Illinois
3180,1535,1435,100,1400000US17201000105,"Census Tract 1,05,Winnebago County",17,201,000105,Illinois
3181,1502,1392,110,1400000US17201000200,"Census Tract 2,Winnebago County",17,201,000200,Illinois
3182,1870,1700,170,1400000US17201000300,"Census Tract 3,Winnebago County",17,201,000300,Illinois
3183,956,927,29,1400000US17201000401,"Census Tract 4,01,Winnebago County",17,201,000401,Illinois
3184,1335,1263,72,1400000US17201000402,"Census Tract 4,02,Winnebago County",17,201,000402,Illinois
3185,1976,1902,74,1400000US17201000403,"Census Tract 4,03,Winnebago County",17,201,000403,Illinois
3186,2121,1952,169,1400000US17201000501,"Census Tract 5,01,Winnebago County",17,201,000501,Illinois
3187,1721,1459,262,1400000US17201000502,"Census Tract 5,02,Winnebago County",17,201,000502,Illinois
3188,1813,1758,55,1400000US17201000506,"Census Tract 5,06,Winnebago County",17,201,000506,Illinois
3189,1598,1471,127,1400000US17201000507,"Census Tract 5,07,Winnebago County",17,201,000507,Illinois
3190,1478,1432,46,1400000US17201000510,"Census Tract 5,10,Winnebago County",17,201,000510,Illinois
3191,1133,1086,47,1400000US17201000511,"Census Tract 5,11,Winnebago County",17,201,000511,Illinois
3192,2580,2533,47,1400000US17201000512,"Census Tract 5,12,Winnebago County",17,201,000512,Illinois
3193,1805,1716,89,1400000US17201000513,"Census Tract 5,13,Winnebago County",17,201,000513,Illinois
3194,1549,1458,91,1400000US17201000514,"Census Tract 5,14,Winnebago County",17,201,000514,Illinois
3195,1196,1124,72,1400000US17201000515,"Census Tract 5,15,Winnebago County",17,201,000515,Illinois
3196,1552,1484,68,1400000US17201000516,"Census Tract 5,16,Winnebago County",17,201,000516,Illinois
3197,1925,1830,95,1400000US17201000600,"Census Tract 6,Winnebago County",17,201,000600,Illinois
3198,1478,1256,222,1400000US17201000700,"Census Tract 7,Winnebago County",17,201,000700,Illinois
3199,1540,1168,372,1400000US17201000800,"Census Tract 8,Winnebago County",17,201,000800,Illinois
3200,1388,1183,205,1400000US17201001000,"Census Tract 10,Winnebago County",17,201,001000,Illinois
3201,923,784,139,1400000US17201001100,"Census Tract 11,Winnebago County",17,201,001100,Illinois
3202,1269,1004,265,1400000US17201001200,"Census Tract 12,Winnebago County",17,201,001200,Illinois
3203,1121,1024,97,1400000US17201001300,"Census Tract 13,Winnebago County",17,201,001300,Illinois
3204,1969,1775,194,1400000US17201001400,"Census Tract 14,Winnebago County",17,201,001400,Illinois
3205,2552,2466,86,1400000US17201001500,"Census Tract 15,Winnebago County",17,201,001500,Illinois
3206,2345,2116,229,1400000US17201001600,"Census Tract 16,Winnebago County",17,201,001600,Illinois
3207,1324,1191,133,1400000US17201001700,"Census Tract 17,Winnebago County",17,201,001700,Illinois
3208,2404,2119,285,1400000US17201001800,"Census Tract 18,Winnebago County",17,201,001800,Illinois
3209,1468,1300,168,1400000US17201001900,"Census Tract 19,Winnebago County",17,201,001900,Illinois
3210,974,765,209,1400000US17201002000,"Census Tract 20,Winnebago County",17,201,002000,Illinois
3211,808,730,78,1400000US17201002100,"Census Tract 21,Winnebago County",17,201,002100,Illinois
3212,1692,1520,172,1400000US17201002200,"Census Tract 22,Winnebago County",17,201,002200,Illinois
3213,886,797,89,1400000US17201002301,"Census Tract 23,01,Winnebago County",17,201,002301,Illinois
3214,616,578,38,1400000US17201002302,"Census Tract 23,02,Winnebago County",17,201,002302,Illinois
3215,1031,841,190,1400000US17201002400,"Census Tract 24,Winnebago County",17,201,002400,Illinois
3216,1006,818,188,1400000US17201002500,"Census Tract 25,Winnebago County",17,201,002500,Illinois
3217,1103,829,274,1400000US17201002600,"Census Tract 26,Winnebago County",17,201,002600,Illinois
3218,1266,1096,170,1400000US17201002700,"Census Tract 27,Winnebago County",17,201,002700,Illinois
3219,542,458,84,1400000US17201002800,"Census Tract 28,Winnebago County",17,201,002800,Illinois
3220,966,824,142,1400000US17201002900,"Census Tract 29,Winnebago County",17,201,002900,Illinois
3221,885,804,81,1400000US17201003000,"Census Tract 30,Winnebago County",17,201,003000,Illinois
3222,1883,1502,381,1400000US17201003100,"Census Tract 31,Winnebago County",17,201,003100,Illinois
3223,1179,1067,112,1400000US17201003200,"Census Tract 32,Winnebago County",17,201,003200,Illinois
3224,1484,1311,173,1400000US17201003300,"Census Tract 33,Winnebago County",17,201,003300,Illinois
3225,1968,1785,183,1400000US17201003400,"Census Tract 34,Winnebago County",17,201,003400,Illinois
3226,1232,1056,176,1400000US17201003500,"Census Tract 35,Winnebago County",17,201,003500,Illinois
3227,799,758,41,1400000US17201003601,"Census Tract 36,01,Winnebago County",17,201,003601,Illinois
3228,1934,1839,95,1400000US17201003602,"Census Tract 36,02,Winnebago County",17,201,003602,Illinois
3229,1301,1183,118,1400000US17201003604,"Census Tract 36,04,Winnebago County",17,201,003604,Illinois
3230,1140,1002,138,1400000US17201003605,"Census Tract 36,05,Winnebago County",17,201,003605,Illinois
3231,1381,1234,147,1400000US17201003606,"Census Tract 36,06,Winnebago County",17,201,003606,Illinois
3232,2074,2000,74,1400000US17201003705,"Census Tract 37,05,Winnebago County",17,201,003705,Illinois
3233,2252,2250,2,1400000US17201003706,"Census Tract 37,06,Winnebago County",17,201,003706,Illinois
3234,1943,1809,134,1400000US17201003707,"Census Tract 37,07,Winnebago County",17,201,003707,Illinois
3235,1515,1392,123,1400000US17201003708,"Census Tract 37,08,Winnebago County",17,201,003708,Illinois
3236,685,661,24,1400000US17201003709,"Census Tract 37,09,Winnebago County",17,201,003709,Illinois
3237,1006,964,42,1400000US17201003710,"Census Tract 37,10,Winnebago County",17,201,003710,Illinois
3238,1675,1503,172,1400000US17201003711,"Census Tract 37,11,Winnebago County",17,201,003711,Illinois
3239,2584,2318,266,1400000US17201003801,"Census Tract 38,01,Winnebago County",17,201,003801,Illinois
3240,2736,2736,0,1400000US17201003805,"Census Tract 38,05,Winnebago County",17,201,003805,Illinois
3241,1728,1703,25,1400000US17201003806,"Census Tract 38,06,Winnebago County",17,201,003806,Illinois
3242,1600,1551,49,1400000US17201003808,"Census Tract 38,08,Winnebago County",17,201,003808,Illinois
3243,2270,2154,116,1400000US17201003809,"Census Tract 38,09,Winnebago County",17,201,003809,Illinois
3244,2770,2678,92,1400000US17201003810,"Census Tract 38,10,Winnebago County",17,201,003810,Illinois
3245,590,559,31,1400000US17201003811,"Census Tract 38,11,Winnebago County",17,201,003811,Illinois
3246,1862,1805,57,1400000US17201003901,"Census Tract 39,01,Winnebago County",17,201,003901,Illinois
3247,2182,2168,14,1400000US17201003903,"Census Tract 39,03,Winnebago County",17,201,003903,Illinois
3248,1895,1838,57,1400000US17201003904,"Census Tract 39,04,Winnebago County",17,201,003904,Illinois
3249,2495,2394,101,1400000US17201004002,"Census Tract 40,02,Winnebago County",17,201,004002,Illinois
3250,976,885,91,1400000US17201004003,"Census Tract 40,03,Winnebago County",17,201,004003,Illinois
3251,2679,2485,194,1400000US17201004004,"Census Tract 40,04,Winnebago County",17,201,004004,Illinois
3252,1129,1083,46,1400000US17201004005,"Census Tract 40,05,Winnebago County",17,201,004005,Illinois
3253,2376,2037,339,1400000US17201004100,"Census Tract 41,Winnebago County",17,201,004100,Illinois
3254,2474,2395,79,1400000US17201004200,"Census Tract 42,Winnebago County",17,201,004200,Illinois
3255,2010,1962,48,1400000US17201004300,"Census Tract 43,Winnebago County",17,201,004300,Illinois
3256,4,4,0,1400000US17201980000,"Census Tract 9800,Winnebago County",17,201,980000,Illinois
3257,1087,1011,76,1400000US17203030100,"Census Tract 301,Woodford County",17,203,030100,Illinois
3258,1291,1154,137,1400000US17203030200,"Census Tract 302,Woodford County",17,203,030200,Illinois
3259,1038,972,66,1400000US17203030300,"Census Tract 303,Woodford County",17,203,030300,Illinois
3260,2439,2329,110,1400000US17203030400,"Census Tract 304,Woodford County",17,203,030400,Illinois
3261,2996,2805,191,1400000US17203030501,"Census Tract 305,01,Woodford County",17,203,030501,Illinois
3262,1098,963,135,1400000US17203030502,"Census Tract 305,02,Woodford County",17,203,030502,Illinois
3263,2607,2551,56,1400000US17203030601,"Census Tract 306,01,Woodford County",17,203,030601,Illinois
3264,1361,1308,53,1400000US17203030602,"Census Tract 306,02,Woodford County",17,203,030602,Illinois
3265,1760,1582,178,1400000US17203030700,"Census Tract 307,Woodford County",17,203,030700,Illinois
