,Abs_Total,Owner occupied,Renter occupied,Geography,NAME,state,State
1,2326,2021,305,1400000US17001000100,"Census Tract 1,Adams County",17|001|000100,Illinois
2,845,672,173,1400000US17001000201,"Census Tract 2,01,Adams County",17|001|000201,Illinois
3,952,664,288,1400000US17001000202,"Census Tract 2,02,Adams County",17|001|000202,Illinois
4,1245,665,580,1400000US17001000400,"Census Tract 4,Adams County",17|001|000400,Illinois
5,779,430,349,1400000US17001000500,"Census Tract 5,Adams County",17|001|000500,Illinois
6,1915,1128,787,1400000US17001000600,"Census Tract 6,Adams County",17|001|000600,Illinois
7,746,48,698,1400000US17001000700,"Census Tract 7,Adams County",17|001|000700,Illinois
8,1035,561,474,1400000US17001000800,"Census Tract 8,Adams County",17|001|000800,Illinois
9,1200,601,599,1400000US17001000900,"Census Tract 9,Adams County",17|001|000900,Illinois
10,1367,1013,354,1400000US17001001001,"Census Tract 10,01,Adams County",17|001|001001,Illinois
11,1187,888,299,1400000US17001001002,"Census Tract 10,02,Adams County",17|001|001002,Illinois
12,3325,2124,1201,1400000US17001001100,"Census Tract 11,Adams County",17|001|001100,Illinois
13,1765,1451,314,1400000US17001010100,"Census Tract 101,Adams County",17|001|010100,Illinois
14,1536,1192,344,1400000US17001010200,"Census Tract 102,Adams County",17|001|010200,Illinois
15,988,833,155,1400000US17001010301,"Census Tract 103,01,Adams County",17|001|010301,Illinois
16,1100,949,151,1400000US17001010302,"Census Tract 103,02,Adams County",17|001|010302,Illinois
17,1297,1253,44,1400000US17001010400,"Census Tract 104,Adams County",17|001|010400,Illinois
18,1181,934,247,1400000US17001010500,"Census Tract 105,Adams County",17|001|010500,Illinois
19,2385,2140,245,1400000US17001010600,"Census Tract 106,Adams County",17|001|010600,Illinois
20,616,468,148,1400000US17003957600,"Census Tract 9576,Alexander County",17|003|957600,Illinois
21,484,390,94,1400000US17003957700,"Census Tract 9577,Alexander County",17|003|957700,Illinois
22,373,331,42,1400000US17003957800,"Census Tract 9578,Alexander County",17|003|957800,Illinois
23,308,157,151,1400000US17003957900,"Census Tract 9579,Alexander County",17|003|957900,Illinois
24,1294,1072,222,1400000US17005951200,"Census Tract 9512,Bond County",17|005|951200,Illinois
25,2052,1233,819,1400000US17005951300,"Census Tract 9513,Bond County",17|005|951300,Illinois
26,1066,910,156,1400000US17005951400,"Census Tract 9514,Bond County",17|005|951400,Illinois
27,1682,1394,288,1400000US17005951500,"Census Tract 9515,Bond County",17|005|951500,Illinois
28,1418,1027,391,1400000US17007010101,"Census Tract 101,01,Boone County",17|007|010101,Illinois
29,1304,730,574,1400000US17007010102,"Census Tract 101,02,Boone County",17|007|010102,Illinois
30,2171,1547,624,1400000US17007010200,"Census Tract 102,Boone County",17|007|010200,Illinois
31,2713,1990,723,1400000US17007010300,"Census Tract 103,Boone County",17|007|010300,Illinois
32,2588,2415,173,1400000US17007010400,"Census Tract 104,Boone County",17|007|010400,Illinois
33,1591,1532,59,1400000US17007010501,"Census Tract 105,01,Boone County",17|007|010501,Illinois
34,1994,1860,134,1400000US17007010502,"Census Tract 105,02,Boone County",17|007|010502,Illinois
35,1310,1118,192,1400000US17007010601,"Census Tract 106,01,Boone County",17|007|010601,Illinois
36,2015,1862,153,1400000US17007010603,"Census Tract 106,03,Boone County",17|007|010603,Illinois
37,1793,1509,284,1400000US17007010604,"Census Tract 106,04,Boone County",17|007|010604,Illinois
38,1007,863,144,1400000US17009970400,"Census Tract 9704,Brown County",17|009|970400,Illinois
39,991,609,382,1400000US17009970500,"Census Tract 9705,Brown County",17|009|970500,Illinois
40,1126,930,196,1400000US17011964700,"Census Tract 9647,Bureau County",17|011|964700,Illinois
41,1242,951,291,1400000US17011964800,"Census Tract 9648,Bureau County",17|011|964800,Illinois
42,1138,819,319,1400000US17011964900,"Census Tract 9649,Bureau County",17|011|964900,Illinois
43,1368,1109,259,1400000US17011965000,"Census Tract 9650,Bureau County",17|011|965000,Illinois
44,1577,1110,467,1400000US17011965100,"Census Tract 9651,Bureau County",17|011|965100,Illinois
45,1620,992,628,1400000US17011965200,"Census Tract 9652,Bureau County",17|011|965200,Illinois
46,1356,1025,331,1400000US17011965300,"Census Tract 9653,Bureau County",17|011|965300,Illinois
47,1746,1268,478,1400000US17011965400,"Census Tract 9654,Bureau County",17|011|965400,Illinois
48,1471,1175,296,1400000US17011965500,"Census Tract 9655,Bureau County",17|011|965500,Illinois
49,1144,973,171,1400000US17011965600,"Census Tract 9656,Bureau County",17|011|965600,Illinois
50,623,538,85,1400000US17013951200,"Census Tract 9512,Calhoun County",17|013|951200,Illinois
51,649,621,28,1400000US17013951300,"Census Tract 9513,Calhoun County",17|013|951300,Illinois
52,1395,1177,218,1400000US17015960100,"Census Tract 9601,Carroll County",17|015|960100,Illinois
53,957,799,158,1400000US17015960200,"Census Tract 9602,Carroll County",17|015|960200,Illinois
54,1432,897,535,1400000US17015960300,"Census Tract 9603,Carroll County",17|015|960300,Illinois
55,806,647,159,1400000US17015960400,"Census Tract 9604,Carroll County",17|015|960400,Illinois
56,1036,859,177,1400000US17015960500,"Census Tract 9605,Carroll County",17|015|960500,Illinois
57,673,566,107,1400000US17015960600,"Census Tract 9606,Carroll County",17|015|960600,Illinois
58,903,758,145,1400000US17017960100,"Census Tract 9601,Cass County",17|017|960100,Illinois
59,1020,798,222,1400000US17017960200,"Census Tract 9602,Cass County",17|017|960200,Illinois
60,1090,900,190,1400000US17017960300,"Census Tract 9603,Cass County",17|017|960300,Illinois
61,1062,748,314,1400000US17017960400,"Census Tract 9604,Cass County",17|017|960400,Illinois
62,908,676,232,1400000US17017960500,"Census Tract 9605,Cass County",17|017|960500,Illinois
63,921,355,566,1400000US17019000200,"Census Tract 2,Champaign County",17|019|000200,Illinois
64,2163,0,2163,1400000US17019000301,"Census Tract 3,01,Champaign County",17|019|000301,Illinois
65,1616,0,1616,1400000US17019000302,"Census Tract 3,02,Champaign County",17|019|000302,Illinois
66,543,0,543,1400000US17019000401,"Census Tract 4,01,Champaign County",17|019|000401,Illinois
67,1140,0,1140,1400000US17019000402,"Census Tract 4,02,Champaign County",17|019|000402,Illinois
68,1847,711,1136,1400000US17019000500,"Census Tract 5,Champaign County",17|019|000500,Illinois
69,1392,678,714,1400000US17019000700,"Census Tract 7,Champaign County",17|019|000700,Illinois
70,2930,767,2163,1400000US17019000800,"Census Tract 8,Champaign County",17|019|000800,Illinois
71,1867,687,1180,1400000US17019000901,"Census Tract 9,01,Champaign County",17|019|000901,Illinois
72,2893,1857,1036,1400000US17019000902,"Census Tract 9,02,Champaign County",17|019|000902,Illinois
73,2111,1148,963,1400000US17019001000,"Census Tract 10,Champaign County",17|019|001000,Illinois
74,1623,1183,440,1400000US17019001100,"Census Tract 11,Champaign County",17|019|001100,Illinois
75,2953,1481,1472,1400000US17019001201,"Census Tract 12,01,Champaign County",17|019|001201,Illinois
76,1915,1418,497,1400000US17019001203,"Census Tract 12,03,Champaign County",17|019|001203,Illinois
77,1353,1117,236,1400000US17019001204,"Census Tract 12,04,Champaign County",17|019|001204,Illinois
78,3269,2056,1213,1400000US17019001205,"Census Tract 12,05,Champaign County",17|019|001205,Illinois
79,893,771,122,1400000US17019001206,"Census Tract 12,06,Champaign County",17|019|001206,Illinois
80,2706,1692,1014,1400000US17019001301,"Census Tract 13,01,Champaign County",17|019|001301,Illinois
81,2030,1507,523,1400000US17019001302,"Census Tract 13,02,Champaign County",17|019|001302,Illinois
82,1590,716,874,1400000US17019001400,"Census Tract 14,Champaign County",17|019|001400,Illinois
83,2350,295,2055,1400000US17019005300,"Census Tract 53,Champaign County",17|019|005300,Illinois
84,2189,691,1498,1400000US17019005401,"Census Tract 54,01,Champaign County",17|019|005401,Illinois
85,1715,1237,478,1400000US17019005402,"Census Tract 54,02,Champaign County",17|019|005402,Illinois
86,2093,1178,915,1400000US17019005500,"Census Tract 55,Champaign County",17|019|005500,Illinois
87,2475,1222,1253,1400000US17019005601,"Census Tract 56,01,Champaign County",17|019|005601,Illinois
88,1216,378,838,1400000US17019005602,"Census Tract 56,02,Champaign County",17|019|005602,Illinois
89,2320,1175,1145,1400000US17019005701,"Census Tract 57,01,Champaign County",17|019|005701,Illinois
90,682,539,143,1400000US17019005702,"Census Tract 57,02,Champaign County",17|019|005702,Illinois
91,1460,786,674,1400000US17019005800,"Census Tract 58,Champaign County",17|019|005800,Illinois
92,394,23,371,1400000US17019005901,"Census Tract 59,01,Champaign County",17|019|005901,Illinois
93,645,0,645,1400000US17019005902,"Census Tract 59,02,Champaign County",17|019|005902,Illinois
94,614,13,601,1400000US17019006000,"Census Tract 60,Champaign County",17|019|006000,Illinois
95,1942,884,1058,1400000US17019010100,"Census Tract 101,Champaign County",17|019|010100,Illinois
96,1993,1475,518,1400000US17019010204,"Census Tract 102,04,Champaign County",17|019|010204,Illinois
97,1198,255,943,1400000US17019010300,"Census Tract 103,Champaign County",17|019|010300,Illinois
98,1773,1464,309,1400000US17019010400,"Census Tract 104,Champaign County",17|019|010400,Illinois
99,1589,1385,204,1400000US17019010500,"Census Tract 105,Champaign County",17|019|010500,Illinois
100,2069,1832,237,1400000US17019010601,"Census Tract 106,01,Champaign County",17|019|010601,Illinois
101,2535,2146,389,1400000US17019010603,"Census Tract 106,03,Champaign County",17|019|010603,Illinois
102,1197,967,230,1400000US17019010604,"Census Tract 106,04,Champaign County",17|019|010604,Illinois
103,1443,1239,204,1400000US17019010701,"Census Tract 107,01,Champaign County",17|019|010701,Illinois
104,1461,1259,202,1400000US17019010702,"Census Tract 107,02,Champaign County",17|019|010702,Illinois
105,1676,1464,212,1400000US17019010800,"Census Tract 108,Champaign County",17|019|010800,Illinois
106,2325,1694,631,1400000US17019010901,"Census Tract 109,01,Champaign County",17|019|010901,Illinois
107,1486,1261,225,1400000US17019010902,"Census Tract 109,02,Champaign County",17|019|010902,Illinois
108,1219,270,949,1400000US17019011001,"Census Tract 110,01,Champaign County",17|019|011001,Illinois
109,1083,368,715,1400000US17019011002,"Census Tract 110,02,Champaign County",17|019|011002,Illinois
110,938,41,897,1400000US17019011100,"Census Tract 111,Champaign County",17|019|011100,Illinois
111,1180,1048,132,1400000US17021958100,"Census Tract 9581,Christian County",17|021|958100,Illinois
112,1532,1114,418,1400000US17021958200,"Census Tract 9582,Christian County",17|021|958200,Illinois
113,1966,1283,683,1400000US17021958300,"Census Tract 9583,Christian County",17|021|958300,Illinois
114,1486,1198,288,1400000US17021958400,"Census Tract 9584,Christian County",17|021|958400,Illinois
115,1057,514,543,1400000US17021958500,"Census Tract 9585,Christian County",17|021|958500,Illinois
116,949,689,260,1400000US17021958600,"Census Tract 9586,Christian County",17|021|958600,Illinois
117,1419,1141,278,1400000US17021958700,"Census Tract 9587,Christian County",17|021|958700,Illinois
118,1091,882,209,1400000US17021958800,"Census Tract 9588,Christian County",17|021|958800,Illinois
119,1051,724,327,1400000US17021958900,"Census Tract 9589,Christian County",17|021|958900,Illinois
120,1836,1667,169,1400000US17021959000,"Census Tract 9590,Christian County",17|021|959000,Illinois
121,1733,1578,155,1400000US17023060100,"Census Tract 601,Clark County",17|023|060100,Illinois
122,1738,1212,526,1400000US17023060200,"Census Tract 602,Clark County",17|023|060200,Illinois
123,2186,1690,496,1400000US17023060300,"Census Tract 603,Clark County",17|023|060300,Illinois
124,722,624,98,1400000US17023060400,"Census Tract 604,Clark County",17|023|060400,Illinois
125,950,854,96,1400000US17025971900,"Census Tract 9719,Clay County",17|025|971900,Illinois
126,1163,851,312,1400000US17025972000,"Census Tract 9720,Clay County",17|025|972000,Illinois
127,2228,1554,674,1400000US17025972100,"Census Tract 9721,Clay County",17|025|972100,Illinois
128,1106,972,134,1400000US17025972200,"Census Tract 9722,Clay County",17|025|972200,Illinois
129,2499,2030,469,1400000US17027900100,"Census Tract 9001,Clinton County",17|027|900100,Illinois
130,658,613,45,1400000US17027900200,"Census Tract 9002,Clinton County",17|027|900200,Illinois
131,2800,2248,552,1400000US17027900300,"Census Tract 9003,Clinton County",17|027|900300,Illinois
132,543,479,64,1400000US17027900401,"Census Tract 9004,01,Clinton County",17|027|900401,Illinois
133,1545,1046,499,1400000US17027900403,"Census Tract 9004,03,Clinton County",17|027|900403,Illinois
134,488,452,36,1400000US17027900404,"Census Tract 9004,04,Clinton County",17|027|900404,Illinois
135,1812,1418,394,1400000US17027900500,"Census Tract 9005,Clinton County",17|027|900500,Illinois
136,1171,1060,111,1400000US17027900601,"Census Tract 9006,01,Clinton County",17|027|900601,Illinois
137,2739,2020,719,1400000US17027900602,"Census Tract 9006,02,Clinton County",17|027|900602,Illinois
138,1165,928,237,1400000US17029000100,"Census Tract 1,Coles County",17|029|000100,Illinois
139,2069,1734,335,1400000US17029000200,"Census Tract 2,Coles County",17|029|000200,Illinois
140,2100,1531,569,1400000US17029000300,"Census Tract 3,Coles County",17|029|000300,Illinois
141,1464,543,921,1400000US17029000400,"Census Tract 4,Coles County",17|029|000400,Illinois
142,2463,1487,976,1400000US17029000500,"Census Tract 5,Coles County",17|029|000500,Illinois
143,1340,1122,218,1400000US17029000600,"Census Tract 6,Coles County",17|029|000600,Illinois
144,1236,645,591,1400000US17029000701,"Census Tract 7,01,Coles County",17|029|000701,Illinois
145,1609,318,1291,1400000US17029000702,"Census Tract 7,02,Coles County",17|029|000702,Illinois
146,606,131,475,1400000US17029000800,"Census Tract 8,Coles County",17|029|000800,Illinois
147,1665,1176,489,1400000US17029000900,"Census Tract 9,Coles County",17|029|000900,Illinois
148,1490,867,623,1400000US17029001000,"Census Tract 10,Coles County",17|029|001000,Illinois
149,1584,672,912,1400000US17029001100,"Census Tract 11,Coles County",17|029|001100,Illinois
150,1478,1028,450,1400000US17029001200,"Census Tract 12,Coles County",17|029|001200,Illinois
151,2411,808,1603,1400000US17031010100,"Census Tract 101,Cook County",17|031|010100,Illinois
152,2996,817,2179,1400000US17031010201,"Census Tract 102,01,Cook County",17|031|010201,Illinois
153,1234,295,939,1400000US17031010202,"Census Tract 102,02,Cook County",17|031|010202,Illinois
154,2995,1098,1897,1400000US17031010300,"Census Tract 103,Cook County",17|031|010300,Illinois
155,2034,553,1481,1400000US17031010400,"Census Tract 104,Cook County",17|031|010400,Illinois
156,2439,414,2025,1400000US17031010501,"Census Tract 105,01,Cook County",17|031|010501,Illinois
157,1539,386,1153,1400000US17031010502,"Census Tract 105,02,Cook County",17|031|010502,Illinois
158,1155,180,975,1400000US17031010503,"Census Tract 105,03,Cook County",17|031|010503,Illinois
159,2917,876,2041,1400000US17031010600,"Census Tract 106,Cook County",17|031|010600,Illinois
160,1564,824,740,1400000US17031010701,"Census Tract 107,01,Cook County",17|031|010701,Illinois
161,1845,393,1452,1400000US17031010702,"Census Tract 107,02,Cook County",17|031|010702,Illinois
162,1624,601,1023,1400000US17031020100,"Census Tract 201,Cook County",17|031|020100,Illinois
163,2037,1529,508,1400000US17031020200,"Census Tract 202,Cook County",17|031|020200,Illinois
164,2197,1620,577,1400000US17031020301,"Census Tract 203,01,Cook County",17|031|020301,Illinois
165,1699,1091,608,1400000US17031020302,"Census Tract 203,02,Cook County",17|031|020302,Illinois
166,1710,814,896,1400000US17031020400,"Census Tract 204,Cook County",17|031|020400,Illinois
167,2160,500,1660,1400000US17031020500,"Census Tract 205,Cook County",17|031|020500,Illinois
168,2051,1000,1051,1400000US17031020601,"Census Tract 206,01,Cook County",17|031|020601,Illinois
169,1672,811,861,1400000US17031020602,"Census Tract 206,02,Cook County",17|031|020602,Illinois
170,762,527,235,1400000US17031020701,"Census Tract 207,01,Cook County",17|031|020701,Illinois
171,2458,1114,1344,1400000US17031020702,"Census Tract 207,02,Cook County",17|031|020702,Illinois
172,2207,945,1262,1400000US17031020801,"Census Tract 208,01,Cook County",17|031|020801,Illinois
173,2077,626,1451,1400000US17031020802,"Census Tract 208,02,Cook County",17|031|020802,Illinois
174,2200,781,1419,1400000US17031020901,"Census Tract 209,01,Cook County",17|031|020901,Illinois
175,1587,727,860,1400000US17031020902,"Census Tract 209,02,Cook County",17|031|020902,Illinois
176,2106,707,1399,1400000US17031030101,"Census Tract 301,01,Cook County",17|031|030101,Illinois
177,1847,673,1174,1400000US17031030102,"Census Tract 301,02,Cook County",17|031|030102,Illinois
178,1014,387,627,1400000US17031030103,"Census Tract 301,03,Cook County",17|031|030103,Illinois
179,987,408,579,1400000US17031030104,"Census Tract 301,04,Cook County",17|031|030104,Illinois
180,2550,1153,1397,1400000US17031030200,"Census Tract 302,Cook County",17|031|030200,Illinois
181,1493,507,986,1400000US17031030300,"Census Tract 303,Cook County",17|031|030300,Illinois
182,1285,511,774,1400000US17031030400,"Census Tract 304,Cook County",17|031|030400,Illinois
183,2965,1457,1508,1400000US17031030500,"Census Tract 305,Cook County",17|031|030500,Illinois
184,1921,461,1460,1400000US17031030601,"Census Tract 306,01,Cook County",17|031|030601,Illinois
185,1414,169,1245,1400000US17031030603,"Census Tract 306,03,Cook County",17|031|030603,Illinois
186,2127,609,1518,1400000US17031030604,"Census Tract 306,04,Cook County",17|031|030604,Illinois
187,844,158,686,1400000US17031030701,"Census Tract 307,01,Cook County",17|031|030701,Illinois
188,1489,933,556,1400000US17031030702,"Census Tract 307,02,Cook County",17|031|030702,Illinois
189,1907,458,1449,1400000US17031030703,"Census Tract 307,03,Cook County",17|031|030703,Illinois
190,1905,825,1080,1400000US17031030706,"Census Tract 307,06,Cook County",17|031|030706,Illinois
191,2138,926,1212,1400000US17031030800,"Census Tract 308,Cook County",17|031|030800,Illinois
192,1484,712,772,1400000US17031030900,"Census Tract 309,Cook County",17|031|030900,Illinois
193,2062,794,1268,1400000US17031031000,"Census Tract 310,Cook County",17|031|031000,Illinois
194,2737,470,2267,1400000US17031031100,"Census Tract 311,Cook County",17|031|031100,Illinois
195,3263,794,2469,1400000US17031031200,"Census Tract 312,Cook County",17|031|031200,Illinois
196,4469,1629,2840,1400000US17031031300,"Census Tract 313,Cook County",17|031|031300,Illinois
197,3117,1468,1649,1400000US17031031400,"Census Tract 314,Cook County",17|031|031400,Illinois
198,1961,406,1555,1400000US17031031501,"Census Tract 315,01,Cook County",17|031|031501,Illinois
199,2449,321,2128,1400000US17031031502,"Census Tract 315,02,Cook County",17|031|031502,Illinois
200,3280,1460,1820,1400000US17031031700,"Census Tract 317,Cook County",17|031|031700,Illinois
201,1005,413,592,1400000US17031031800,"Census Tract 318,Cook County",17|031|031800,Illinois
202,1347,533,814,1400000US17031031900,"Census Tract 319,Cook County",17|031|031900,Illinois
203,4207,1244,2963,1400000US17031032100,"Census Tract 321,Cook County",17|031|032100,Illinois
204,1810,871,939,1400000US17031040100,"Census Tract 401,Cook County",17|031|040100,Illinois
205,3033,1222,1811,1400000US17031040201,"Census Tract 402,01,Cook County",17|031|040201,Illinois
206,2876,866,2010,1400000US17031040202,"Census Tract 402,02,Cook County",17|031|040202,Illinois
207,1125,638,487,1400000US17031040300,"Census Tract 403,Cook County",17|031|040300,Illinois
208,1450,893,557,1400000US17031040401,"Census Tract 404,01,Cook County",17|031|040401,Illinois
209,2424,676,1748,1400000US17031040402,"Census Tract 404,02,Cook County",17|031|040402,Illinois
210,1253,428,825,1400000US17031040600,"Census Tract 406,Cook County",17|031|040600,Illinois
211,1646,734,912,1400000US17031040700,"Census Tract 407,Cook County",17|031|040700,Illinois
212,785,348,437,1400000US17031040800,"Census Tract 408,Cook County",17|031|040800,Illinois
213,1108,421,687,1400000US17031040900,"Census Tract 409,Cook County",17|031|040900,Illinois
214,1173,442,731,1400000US17031050100,"Census Tract 501,Cook County",17|031|050100,Illinois
215,2082,1365,717,1400000US17031050200,"Census Tract 502,Cook County",17|031|050200,Illinois
216,1091,675,416,1400000US17031050300,"Census Tract 503,Cook County",17|031|050300,Illinois
217,2054,1261,793,1400000US17031050500,"Census Tract 505,Cook County",17|031|050500,Illinois
218,1121,543,578,1400000US17031050600,"Census Tract 506,Cook County",17|031|050600,Illinois
219,692,396,296,1400000US17031050700,"Census Tract 507,Cook County",17|031|050700,Illinois
220,535,251,284,1400000US17031050800,"Census Tract 508,Cook County",17|031|050800,Illinois
221,648,264,384,1400000US17031050900,"Census Tract 509,Cook County",17|031|050900,Illinois
222,707,444,263,1400000US17031051000,"Census Tract 510,Cook County",17|031|051000,Illinois
223,753,385,368,1400000US17031051100,"Census Tract 511,Cook County",17|031|051100,Illinois
224,613,269,344,1400000US17031051200,"Census Tract 512,Cook County",17|031|051200,Illinois
225,1091,840,251,1400000US17031051300,"Census Tract 513,Cook County",17|031|051300,Illinois
226,981,620,361,1400000US17031051400,"Census Tract 514,Cook County",17|031|051400,Illinois
227,1346,761,585,1400000US17031060100,"Census Tract 601,Cook County",17|031|060100,Illinois
228,1101,415,686,1400000US17031060200,"Census Tract 602,Cook County",17|031|060200,Illinois
229,1216,475,741,1400000US17031060300,"Census Tract 603,Cook County",17|031|060300,Illinois
230,1614,791,823,1400000US17031060400,"Census Tract 604,Cook County",17|031|060400,Illinois
231,679,166,513,1400000US17031060500,"Census Tract 605,Cook County",17|031|060500,Illinois
232,3555,1682,1873,1400000US17031060800,"Census Tract 608,Cook County",17|031|060800,Illinois
233,4794,2263,2531,1400000US17031060900,"Census Tract 609,Cook County",17|031|060900,Illinois
234,1159,331,828,1400000US17031061000,"Census Tract 610,Cook County",17|031|061000,Illinois
235,713,212,501,1400000US17031061100,"Census Tract 611,Cook County",17|031|061100,Illinois
236,821,369,452,1400000US17031061200,"Census Tract 612,Cook County",17|031|061200,Illinois
237,899,313,586,1400000US17031061500,"Census Tract 615,Cook County",17|031|061500,Illinois
238,742,122,620,1400000US17031061800,"Census Tract 618,Cook County",17|031|061800,Illinois
239,2415,492,1923,1400000US17031061901,"Census Tract 619,01,Cook County",17|031|061901,Illinois
240,2882,1009,1873,1400000US17031061902,"Census Tract 619,02,Cook County",17|031|061902,Illinois
241,1631,421,1210,1400000US17031062000,"Census Tract 620,Cook County",17|031|062000,Illinois
242,1906,577,1329,1400000US17031062100,"Census Tract 621,Cook County",17|031|062100,Illinois
243,1296,746,550,1400000US17031062200,"Census Tract 622,Cook County",17|031|062200,Illinois
244,637,386,251,1400000US17031062300,"Census Tract 623,Cook County",17|031|062300,Illinois
245,737,486,251,1400000US17031062400,"Census Tract 624,Cook County",17|031|062400,Illinois
246,688,399,289,1400000US17031062500,"Census Tract 625,Cook County",17|031|062500,Illinois
247,952,623,329,1400000US17031062600,"Census Tract 626,Cook County",17|031|062600,Illinois
248,1265,654,611,1400000US17031062700,"Census Tract 627,Cook County",17|031|062700,Illinois
249,1433,735,698,1400000US17031062800,"Census Tract 628,Cook County",17|031|062800,Illinois
250,1820,871,949,1400000US17031062900,"Census Tract 629,Cook County",17|031|062900,Illinois
251,1808,614,1194,1400000US17031063000,"Census Tract 630,Cook County",17|031|063000,Illinois
252,1384,366,1018,1400000US17031063100,"Census Tract 631,Cook County",17|031|063100,Illinois
253,4392,1386,3006,1400000US17031063200,"Census Tract 632,Cook County",17|031|063200,Illinois
254,1998,247,1751,1400000US17031063301,"Census Tract 633,01,Cook County",17|031|063301,Illinois
255,2737,746,1991,1400000US17031063302,"Census Tract 633,02,Cook County",17|031|063302,Illinois
256,857,421,436,1400000US17031063303,"Census Tract 633,03,Cook County",17|031|063303,Illinois
257,1283,268,1015,1400000US17031063400,"Census Tract 634,Cook County",17|031|063400,Illinois
258,2413,939,1474,1400000US17031070101,"Census Tract 701,01,Cook County",17|031|070101,Illinois
259,2124,646,1478,1400000US17031070102,"Census Tract 701,02,Cook County",17|031|070102,Illinois
260,1105,75,1030,1400000US17031070103,"Census Tract 701,03,Cook County",17|031|070103,Illinois
261,2060,707,1353,1400000US17031070200,"Census Tract 702,Cook County",17|031|070200,Illinois
262,1597,760,837,1400000US17031070300,"Census Tract 703,Cook County",17|031|070300,Illinois
263,1542,754,788,1400000US17031070400,"Census Tract 704,Cook County",17|031|070400,Illinois
264,1286,655,631,1400000US17031070500,"Census Tract 705,Cook County",17|031|070500,Illinois
265,1197,772,425,1400000US17031070600,"Census Tract 706,Cook County",17|031|070600,Illinois
266,1698,938,760,1400000US17031070700,"Census Tract 707,Cook County",17|031|070700,Illinois
267,1021,486,535,1400000US17031071000,"Census Tract 710,Cook County",17|031|071000,Illinois
268,1120,539,581,1400000US17031071100,"Census Tract 711,Cook County",17|031|071100,Illinois
269,1008,580,428,1400000US17031071200,"Census Tract 712,Cook County",17|031|071200,Illinois
270,2140,1095,1045,1400000US17031071300,"Census Tract 713,Cook County",17|031|071300,Illinois
271,2881,1398,1483,1400000US17031071400,"Census Tract 714,Cook County",17|031|071400,Illinois
272,3819,1195,2624,1400000US17031071500,"Census Tract 715,Cook County",17|031|071500,Illinois
273,755,510,245,1400000US17031071600,"Census Tract 716,Cook County",17|031|071600,Illinois
274,635,375,260,1400000US17031071700,"Census Tract 717,Cook County",17|031|071700,Illinois
275,1107,705,402,1400000US17031071800,"Census Tract 718,Cook County",17|031|071800,Illinois
276,4165,2265,1900,1400000US17031080100,"Census Tract 801,Cook County",17|031|080100,Illinois
277,2197,1276,921,1400000US17031080201,"Census Tract 802,01,Cook County",17|031|080201,Illinois
278,2507,1289,1218,1400000US17031080202,"Census Tract 802,02,Cook County",17|031|080202,Illinois
279,2891,1345,1546,1400000US17031080300,"Census Tract 803,Cook County",17|031|080300,Illinois
280,2030,838,1192,1400000US17031080400,"Census Tract 804,Cook County",17|031|080400,Illinois
281,4909,707,4202,1400000US17031081000,"Census Tract 810,Cook County",17|031|081000,Illinois
282,2924,704,2220,1400000US17031081100,"Census Tract 811,Cook County",17|031|081100,Illinois
283,2952,1350,1602,1400000US17031081201,"Census Tract 812,01,Cook County",17|031|081201,Illinois
284,1922,1468,454,1400000US17031081202,"Census Tract 812,02,Cook County",17|031|081202,Illinois
285,3740,2285,1455,1400000US17031081300,"Census Tract 813,Cook County",17|031|081300,Illinois
286,1446,734,712,1400000US17031081401,"Census Tract 814,01,Cook County",17|031|081401,Illinois
287,3322,1340,1982,1400000US17031081402,"Census Tract 814,02,Cook County",17|031|081402,Illinois
288,6149,1399,4750,1400000US17031081403,"Census Tract 814,03,Cook County",17|031|081403,Illinois
289,3294,1788,1506,1400000US17031081500,"Census Tract 815,Cook County",17|031|081500,Illinois
290,2461,938,1523,1400000US17031081600,"Census Tract 816,Cook County",17|031|081600,Illinois
291,3206,831,2375,1400000US17031081700,"Census Tract 817,Cook County",17|031|081700,Illinois
292,7037,3030,4007,1400000US17031081800,"Census Tract 818,Cook County",17|031|081800,Illinois
293,652,339,313,1400000US17031081900,"Census Tract 819,Cook County",17|031|081900,Illinois
294,1390,1268,122,1400000US17031090100,"Census Tract 901,Cook County",17|031|090100,Illinois
295,2638,1986,652,1400000US17031090200,"Census Tract 902,Cook County",17|031|090200,Illinois
296,526,425,101,1400000US17031090300,"Census Tract 903,Cook County",17|031|090300,Illinois
297,2176,1535,641,1400000US17031100100,"Census Tract 1001,Cook County",17|031|100100,Illinois
298,2865,2022,843,1400000US17031100200,"Census Tract 1002,Cook County",17|031|100200,Illinois
299,2750,1723,1027,1400000US17031100300,"Census Tract 1003,Cook County",17|031|100300,Illinois
300,1291,1229,62,1400000US17031100400,"Census Tract 1004,Cook County",17|031|100400,Illinois
301,2332,2073,259,1400000US17031100500,"Census Tract 1005,Cook County",17|031|100500,Illinois
302,1910,1422,488,1400000US17031100600,"Census Tract 1006,Cook County",17|031|100600,Illinois
303,1883,1723,160,1400000US17031100700,"Census Tract 1007,Cook County",17|031|100700,Illinois
304,2221,1416,805,1400000US17031110100,"Census Tract 1101,Cook County",17|031|110100,Illinois
305,1346,636,710,1400000US17031110200,"Census Tract 1102,Cook County",17|031|110200,Illinois
306,1815,1567,248,1400000US17031110300,"Census Tract 1103,Cook County",17|031|110300,Illinois
307,1890,1245,645,1400000US17031110400,"Census Tract 1104,Cook County",17|031|110400,Illinois
308,1911,1236,675,1400000US17031110501,"Census Tract 1105,01,Cook County",17|031|110501,Illinois
309,1575,957,618,1400000US17031110502,"Census Tract 1105,02,Cook County",17|031|110502,Illinois
310,1548,1476,72,1400000US17031120100,"Census Tract 1201,Cook County",17|031|120100,Illinois
311,1769,1424,345,1400000US17031120200,"Census Tract 1202,Cook County",17|031|120200,Illinois
312,2568,2480,88,1400000US17031120300,"Census Tract 1203,Cook County",17|031|120300,Illinois
313,1227,1048,179,1400000US17031120400,"Census Tract 1204,Cook County",17|031|120400,Illinois
314,1842,1024,818,1400000US17031130100,"Census Tract 1301,Cook County",17|031|130100,Illinois
315,715,605,110,1400000US17031130200,"Census Tract 1302,Cook County",17|031|130200,Illinois
316,1834,786,1048,1400000US17031130300,"Census Tract 1303,Cook County",17|031|130300,Illinois
317,1197,414,783,1400000US17031140100,"Census Tract 1401,Cook County",17|031|140100,Illinois
318,1942,612,1330,1400000US17031140200,"Census Tract 1402,Cook County",17|031|140200,Illinois
319,906,266,640,1400000US17031140301,"Census Tract 1403,01,Cook County",17|031|140301,Illinois
320,1319,576,743,1400000US17031140302,"Census Tract 1403,02,Cook County",17|031|140302,Illinois
321,2158,1660,498,1400000US17031140400,"Census Tract 1404,Cook County",17|031|140400,Illinois
322,1333,565,768,1400000US17031140500,"Census Tract 1405,Cook County",17|031|140500,Illinois
323,846,366,480,1400000US17031140601,"Census Tract 1406,01,Cook County",17|031|140601,Illinois
324,1786,576,1210,1400000US17031140602,"Census Tract 1406,02,Cook County",17|031|140602,Illinois
325,1086,392,694,1400000US17031140701,"Census Tract 1407,01,Cook County",17|031|140701,Illinois
326,2048,658,1390,1400000US17031140702,"Census Tract 1407,02,Cook County",17|031|140702,Illinois
327,2479,1063,1416,1400000US17031140800,"Census Tract 1408,Cook County",17|031|140800,Illinois
328,2791,1620,1171,1400000US17031150200,"Census Tract 1502,Cook County",17|031|150200,Illinois
329,3052,1640,1412,1400000US17031150300,"Census Tract 1503,Cook County",17|031|150300,Illinois
330,1795,1060,735,1400000US17031150401,"Census Tract 1504,01,Cook County",17|031|150401,Illinois
331,1338,830,508,1400000US17031150402,"Census Tract 1504,02,Cook County",17|031|150402,Illinois
332,1486,1159,327,1400000US17031150501,"Census Tract 1505,01,Cook County",17|031|150501,Illinois
333,1577,1034,543,1400000US17031150502,"Census Tract 1505,02,Cook County",17|031|150502,Illinois
334,1458,1016,442,1400000US17031150600,"Census Tract 1506,Cook County",17|031|150600,Illinois
335,1391,910,481,1400000US17031150700,"Census Tract 1507,Cook County",17|031|150700,Illinois
336,1665,1144,521,1400000US17031150800,"Census Tract 1508,Cook County",17|031|150800,Illinois
337,899,518,381,1400000US17031151001,"Census Tract 1510,01,Cook County",17|031|151001,Illinois
338,1589,711,878,1400000US17031151002,"Census Tract 1510,02,Cook County",17|031|151002,Illinois
339,1849,1013,836,1400000US17031151100,"Census Tract 1511,Cook County",17|031|151100,Illinois
340,1297,1063,234,1400000US17031151200,"Census Tract 1512,Cook County",17|031|151200,Illinois
341,1011,635,376,1400000US17031160100,"Census Tract 1601,Cook County",17|031|160100,Illinois
342,1246,856,390,1400000US17031160200,"Census Tract 1602,Cook County",17|031|160200,Illinois
343,1767,864,903,1400000US17031160300,"Census Tract 1603,Cook County",17|031|160300,Illinois
344,1983,991,992,1400000US17031160400,"Census Tract 1604,Cook County",17|031|160400,Illinois
345,1323,586,737,1400000US17031160501,"Census Tract 1605,01,Cook County",17|031|160501,Illinois
346,1516,754,762,1400000US17031160502,"Census Tract 1605,02,Cook County",17|031|160502,Illinois
347,1456,761,695,1400000US17031160601,"Census Tract 1606,01,Cook County",17|031|160601,Illinois
348,1488,785,703,1400000US17031160602,"Census Tract 1606,02,Cook County",17|031|160602,Illinois
349,2551,1239,1312,1400000US17031160700,"Census Tract 1607,Cook County",17|031|160700,Illinois
350,1874,782,1092,1400000US17031160800,"Census Tract 1608,Cook County",17|031|160800,Illinois
351,1105,639,466,1400000US17031160900,"Census Tract 1609,Cook County",17|031|160900,Illinois
352,807,443,364,1400000US17031161000,"Census Tract 1610,Cook County",17|031|161000,Illinois
353,777,581,196,1400000US17031161100,"Census Tract 1611,Cook County",17|031|161100,Illinois
354,1080,646,434,1400000US17031161200,"Census Tract 1612,Cook County",17|031|161200,Illinois
355,1493,588,905,1400000US17031161300,"Census Tract 1613,Cook County",17|031|161300,Illinois
356,1153,937,216,1400000US17031170100,"Census Tract 1701,Cook County",17|031|170100,Illinois
357,1243,1090,153,1400000US17031170200,"Census Tract 1702,Cook County",17|031|170200,Illinois
358,1836,1287,549,1400000US17031170300,"Census Tract 1703,Cook County",17|031|170300,Illinois
359,1729,1514,215,1400000US17031170400,"Census Tract 1704,Cook County",17|031|170400,Illinois
360,2049,1592,457,1400000US17031170500,"Census Tract 1705,Cook County",17|031|170500,Illinois
361,967,900,67,1400000US17031170600,"Census Tract 1706,Cook County",17|031|170600,Illinois
362,1138,871,267,1400000US17031170700,"Census Tract 1707,Cook County",17|031|170700,Illinois
363,1437,1188,249,1400000US17031170800,"Census Tract 1708,Cook County",17|031|170800,Illinois
364,660,417,243,1400000US17031170900,"Census Tract 1709,Cook County",17|031|170900,Illinois
365,2734,1954,780,1400000US17031171000,"Census Tract 1710,Cook County",17|031|171000,Illinois
366,1349,999,350,1400000US17031171100,"Census Tract 1711,Cook County",17|031|171100,Illinois
367,2231,1500,731,1400000US17031180100,"Census Tract 1801,Cook County",17|031|180100,Illinois
368,831,211,620,1400000US17031190100,"Census Tract 1901,Cook County",17|031|190100,Illinois
369,1600,933,667,1400000US17031190200,"Census Tract 1902,Cook County",17|031|190200,Illinois
370,1915,982,933,1400000US17031190300,"Census Tract 1903,Cook County",17|031|190300,Illinois
371,1307,1034,273,1400000US17031190401,"Census Tract 1904,01,Cook County",17|031|190401,Illinois
372,1796,896,900,1400000US17031190402,"Census Tract 1904,02,Cook County",17|031|190402,Illinois
373,1091,755,336,1400000US17031190601,"Census Tract 1906,01,Cook County",17|031|190601,Illinois
374,1581,1170,411,1400000US17031190602,"Census Tract 1906,02,Cook County",17|031|190602,Illinois
375,852,373,479,1400000US17031190701,"Census Tract 1907,01,Cook County",17|031|190701,Illinois
376,1517,650,867,1400000US17031190702,"Census Tract 1907,02,Cook County",17|031|190702,Illinois
377,1909,790,1119,1400000US17031190800,"Census Tract 1908,Cook County",17|031|190800,Illinois
378,618,268,350,1400000US17031190900,"Census Tract 1909,Cook County",17|031|190900,Illinois
379,772,481,291,1400000US17031191000,"Census Tract 1910,Cook County",17|031|191000,Illinois
380,1923,774,1149,1400000US17031191100,"Census Tract 1911,Cook County",17|031|191100,Illinois
381,1092,446,646,1400000US17031191200,"Census Tract 1912,Cook County",17|031|191200,Illinois
382,1560,835,725,1400000US17031191301,"Census Tract 1913,01,Cook County",17|031|191301,Illinois
383,1186,674,512,1400000US17031191302,"Census Tract 1913,02,Cook County",17|031|191302,Illinois
384,1323,804,519,1400000US17031200100,"Census Tract 2001,Cook County",17|031|200100,Illinois
385,1633,968,665,1400000US17031200200,"Census Tract 2002,Cook County",17|031|200200,Illinois
386,688,251,437,1400000US17031200300,"Census Tract 2003,Cook County",17|031|200300,Illinois
387,926,462,464,1400000US17031200401,"Census Tract 2004,01,Cook County",17|031|200401,Illinois
388,1312,636,676,1400000US17031200402,"Census Tract 2004,02,Cook County",17|031|200402,Illinois
389,1679,876,803,1400000US17031210100,"Census Tract 2101,Cook County",17|031|210100,Illinois
390,818,298,520,1400000US17031210400,"Census Tract 2104,Cook County",17|031|210400,Illinois
391,1336,439,897,1400000US17031210501,"Census Tract 2105,01,Cook County",17|031|210501,Illinois
392,1572,501,1071,1400000US17031210502,"Census Tract 2105,02,Cook County",17|031|210502,Illinois
393,1139,499,640,1400000US17031210601,"Census Tract 2106,01,Cook County",17|031|210601,Illinois
394,1504,669,835,1400000US17031210602,"Census Tract 2106,02,Cook County",17|031|210602,Illinois
395,1452,595,857,1400000US17031210700,"Census Tract 2107,Cook County",17|031|210700,Illinois
396,424,149,275,1400000US17031210800,"Census Tract 2108,Cook County",17|031|210800,Illinois
397,1401,836,565,1400000US17031210900,"Census Tract 2109,Cook County",17|031|210900,Illinois
398,905,452,453,1400000US17031220300,"Census Tract 2203,Cook County",17|031|220300,Illinois
399,1208,493,715,1400000US17031220400,"Census Tract 2204,Cook County",17|031|220400,Illinois
400,1224,521,703,1400000US17031220500,"Census Tract 2205,Cook County",17|031|220500,Illinois
401,734,318,416,1400000US17031220601,"Census Tract 2206,01,Cook County",17|031|220601,Illinois
402,2649,458,2191,1400000US17031220602,"Census Tract 2206,02,Cook County",17|031|220602,Illinois
403,1111,371,740,1400000US17031220701,"Census Tract 2207,01,Cook County",17|031|220701,Illinois
404,1641,530,1111,1400000US17031220702,"Census Tract 2207,02,Cook County",17|031|220702,Illinois
405,1054,429,625,1400000US17031220901,"Census Tract 2209,01,Cook County",17|031|220901,Illinois
406,990,438,552,1400000US17031220902,"Census Tract 2209,02,Cook County",17|031|220902,Illinois
407,1063,343,720,1400000US17031221000,"Census Tract 2210,Cook County",17|031|221000,Illinois
408,2011,625,1386,1400000US17031221100,"Census Tract 2211,Cook County",17|031|221100,Illinois
409,1226,554,672,1400000US17031221200,"Census Tract 2212,Cook County",17|031|221200,Illinois
410,1444,304,1140,1400000US17031221300,"Census Tract 2213,Cook County",17|031|221300,Illinois
411,1523,480,1043,1400000US17031221400,"Census Tract 2214,Cook County",17|031|221400,Illinois
412,1365,422,943,1400000US17031221500,"Census Tract 2215,Cook County",17|031|221500,Illinois
413,1417,729,688,1400000US17031221600,"Census Tract 2216,Cook County",17|031|221600,Illinois
414,1008,460,548,1400000US17031222200,"Census Tract 2222,Cook County",17|031|222200,Illinois
415,563,294,269,1400000US17031222500,"Census Tract 2225,Cook County",17|031|222500,Illinois
416,781,272,509,1400000US17031222600,"Census Tract 2226,Cook County",17|031|222600,Illinois
417,838,235,603,1400000US17031222700,"Census Tract 2227,Cook County",17|031|222700,Illinois
418,407,76,331,1400000US17031222800,"Census Tract 2228,Cook County",17|031|222800,Illinois
419,369,140,229,1400000US17031222900,"Census Tract 2229,Cook County",17|031|222900,Illinois
420,657,306,351,1400000US17031230100,"Census Tract 2301,Cook County",17|031|230100,Illinois
421,695,244,451,1400000US17031230200,"Census Tract 2302,Cook County",17|031|230200,Illinois
422,249,80,169,1400000US17031230300,"Census Tract 2303,Cook County",17|031|230300,Illinois
423,756,468,288,1400000US17031230400,"Census Tract 2304,Cook County",17|031|230400,Illinois
424,1266,318,948,1400000US17031230500,"Census Tract 2305,Cook County",17|031|230500,Illinois
425,1995,590,1405,1400000US17031230600,"Census Tract 2306,Cook County",17|031|230600,Illinois
426,1940,917,1023,1400000US17031230700,"Census Tract 2307,Cook County",17|031|230700,Illinois
427,326,218,108,1400000US17031230800,"Census Tract 2308,Cook County",17|031|230800,Illinois
428,2005,752,1253,1400000US17031230900,"Census Tract 2309,Cook County",17|031|230900,Illinois
429,410,204,206,1400000US17031231100,"Census Tract 2311,Cook County",17|031|231100,Illinois
430,2050,820,1230,1400000US17031231200,"Census Tract 2312,Cook County",17|031|231200,Illinois
431,2149,641,1508,1400000US17031231500,"Census Tract 2315,Cook County",17|031|231500,Illinois
432,805,458,347,1400000US17031240200,"Census Tract 2402,Cook County",17|031|240200,Illinois
433,615,331,284,1400000US17031240300,"Census Tract 2403,Cook County",17|031|240300,Illinois
434,1301,814,487,1400000US17031240500,"Census Tract 2405,Cook County",17|031|240500,Illinois
435,656,408,248,1400000US17031240600,"Census Tract 2406,Cook County",17|031|240600,Illinois
436,712,230,482,1400000US17031240700,"Census Tract 2407,Cook County",17|031|240700,Illinois
437,625,347,278,1400000US17031240800,"Census Tract 2408,Cook County",17|031|240800,Illinois
438,539,135,404,1400000US17031240900,"Census Tract 2409,Cook County",17|031|240900,Illinois
439,796,265,531,1400000US17031241000,"Census Tract 2410,Cook County",17|031|241000,Illinois
440,1486,593,893,1400000US17031241100,"Census Tract 2411,Cook County",17|031|241100,Illinois
441,836,306,530,1400000US17031241200,"Census Tract 2412,Cook County",17|031|241200,Illinois
442,770,387,383,1400000US17031241300,"Census Tract 2413,Cook County",17|031|241300,Illinois
443,2602,728,1874,1400000US17031241400,"Census Tract 2414,Cook County",17|031|241400,Illinois
444,1260,515,745,1400000US17031241500,"Census Tract 2415,Cook County",17|031|241500,Illinois
445,1626,396,1230,1400000US17031241600,"Census Tract 2416,Cook County",17|031|241600,Illinois
446,2070,626,1444,1400000US17031242000,"Census Tract 2420,Cook County",17|031|242000,Illinois
447,1971,1078,893,1400000US17031242100,"Census Tract 2421,Cook County",17|031|242100,Illinois
448,1840,842,998,1400000US17031242200,"Census Tract 2422,Cook County",17|031|242200,Illinois
449,1749,764,985,1400000US17031242300,"Census Tract 2423,Cook County",17|031|242300,Illinois
450,1477,408,1069,1400000US17031242400,"Census Tract 2424,Cook County",17|031|242400,Illinois
451,1582,447,1135,1400000US17031242500,"Census Tract 2425,Cook County",17|031|242500,Illinois
452,2499,783,1716,1400000US17031242600,"Census Tract 2426,Cook County",17|031|242600,Illinois
453,808,293,515,1400000US17031242700,"Census Tract 2427,Cook County",17|031|242700,Illinois
454,660,384,276,1400000US17031242800,"Census Tract 2428,Cook County",17|031|242800,Illinois
455,802,430,372,1400000US17031242900,"Census Tract 2429,Cook County",17|031|242900,Illinois
456,1079,566,513,1400000US17031243000,"Census Tract 2430,Cook County",17|031|243000,Illinois
457,944,479,465,1400000US17031243100,"Census Tract 2431,Cook County",17|031|243100,Illinois
458,1008,608,400,1400000US17031243200,"Census Tract 2432,Cook County",17|031|243200,Illinois
459,1241,434,807,1400000US17031243300,"Census Tract 2433,Cook County",17|031|243300,Illinois
460,1377,544,833,1400000US17031243400,"Census Tract 2434,Cook County",17|031|243400,Illinois
461,2228,946,1282,1400000US17031243500,"Census Tract 2435,Cook County",17|031|243500,Illinois
462,858,503,355,1400000US17031250200,"Census Tract 2502,Cook County",17|031|250200,Illinois
463,1534,736,798,1400000US17031250300,"Census Tract 2503,Cook County",17|031|250300,Illinois
464,2020,930,1090,1400000US17031250400,"Census Tract 2504,Cook County",17|031|250400,Illinois
465,2770,2226,544,1400000US17031250500,"Census Tract 2505,Cook County",17|031|250500,Illinois
466,1292,985,307,1400000US17031250600,"Census Tract 2506,Cook County",17|031|250600,Illinois
467,2216,654,1562,1400000US17031250700,"Census Tract 2507,Cook County",17|031|250700,Illinois
468,777,531,246,1400000US17031250800,"Census Tract 2508,Cook County",17|031|250800,Illinois
469,382,178,204,1400000US17031251000,"Census Tract 2510,Cook County",17|031|251000,Illinois
470,1709,598,1111,1400000US17031251100,"Census Tract 2511,Cook County",17|031|251100,Illinois
471,1241,725,516,1400000US17031251200,"Census Tract 2512,Cook County",17|031|251200,Illinois
472,1455,631,824,1400000US17031251300,"Census Tract 2513,Cook County",17|031|251300,Illinois
473,2038,483,1555,1400000US17031251400,"Census Tract 2514,Cook County",17|031|251400,Illinois
474,1299,443,856,1400000US17031251500,"Census Tract 2515,Cook County",17|031|251500,Illinois
475,1234,403,831,1400000US17031251600,"Census Tract 2516,Cook County",17|031|251600,Illinois
476,414,158,256,1400000US17031251700,"Census Tract 2517,Cook County",17|031|251700,Illinois
477,1624,338,1286,1400000US17031251800,"Census Tract 2518,Cook County",17|031|251800,Illinois
478,2214,534,1680,1400000US17031251900,"Census Tract 2519,Cook County",17|031|251900,Illinois
479,2502,474,2028,1400000US17031252000,"Census Tract 2520,Cook County",17|031|252000,Illinois
480,690,192,498,1400000US17031252101,"Census Tract 2521,01,Cook County",17|031|252101,Illinois
481,2190,987,1203,1400000US17031252102,"Census Tract 2521,02,Cook County",17|031|252102,Illinois
482,1002,359,643,1400000US17031252201,"Census Tract 2522,01,Cook County",17|031|252201,Illinois
483,1718,459,1259,1400000US17031252202,"Census Tract 2522,02,Cook County",17|031|252202,Illinois
484,539,76,463,1400000US17031260100,"Census Tract 2601,Cook County",17|031|260100,Illinois
485,369,104,265,1400000US17031260200,"Census Tract 2602,Cook County",17|031|260200,Illinois
486,569,73,496,1400000US17031260300,"Census Tract 2603,Cook County",17|031|260300,Illinois
487,480,80,400,1400000US17031260400,"Census Tract 2604,Cook County",17|031|260400,Illinois
488,594,253,341,1400000US17031260500,"Census Tract 2605,Cook County",17|031|260500,Illinois
489,611,259,352,1400000US17031260600,"Census Tract 2606,Cook County",17|031|260600,Illinois
490,555,172,383,1400000US17031260700,"Census Tract 2607,Cook County",17|031|260700,Illinois
491,770,154,616,1400000US17031260800,"Census Tract 2608,Cook County",17|031|260800,Illinois
492,397,158,239,1400000US17031260900,"Census Tract 2609,Cook County",17|031|260900,Illinois
493,936,263,673,1400000US17031261000,"Census Tract 2610,Cook County",17|031|261000,Illinois
494,591,86,505,1400000US17031270500,"Census Tract 2705,Cook County",17|031|270500,Illinois
495,375,94,281,1400000US17031271200,"Census Tract 2712,Cook County",17|031|271200,Illinois
496,343,114,229,1400000US17031271300,"Census Tract 2713,Cook County",17|031|271300,Illinois
497,526,110,416,1400000US17031271400,"Census Tract 2714,Cook County",17|031|271400,Illinois
498,528,209,319,1400000US17031271500,"Census Tract 2715,Cook County",17|031|271500,Illinois
499,206,60,146,1400000US17031271800,"Census Tract 2718,Cook County",17|031|271800,Illinois
500,4698,1398,3300,1400000US17031280100,"Census Tract 2801,Cook County",17|031|280100,Illinois
501,565,162,403,1400000US17031280400,"Census Tract 2804,Cook County",17|031|280400,Illinois
502,374,68,306,1400000US17031280800,"Census Tract 2808,Cook County",17|031|280800,Illinois
503,367,104,263,1400000US17031280900,"Census Tract 2809,Cook County",17|031|280900,Illinois
504,3939,1495,2444,1400000US17031281900,"Census Tract 2819,Cook County",17|031|281900,Illinois
505,860,413,447,1400000US17031282700,"Census Tract 2827,Cook County",17|031|282700,Illinois
506,563,210,353,1400000US17031282800,"Census Tract 2828,Cook County",17|031|282800,Illinois
507,1319,343,976,1400000US17031283100,"Census Tract 2831,Cook County",17|031|283100,Illinois
508,763,267,496,1400000US17031283200,"Census Tract 2832,Cook County",17|031|283200,Illinois
509,1631,648,983,1400000US17031283800,"Census Tract 2838,Cook County",17|031|283800,Illinois
510,1307,207,1100,1400000US17031290900,"Census Tract 2909,Cook County",17|031|290900,Illinois
511,714,164,550,1400000US17031291200,"Census Tract 2912,Cook County",17|031|291200,Illinois
512,525,114,411,1400000US17031291600,"Census Tract 2916,Cook County",17|031|291600,Illinois
513,961,200,761,1400000US17031292200,"Census Tract 2922,Cook County",17|031|292200,Illinois
514,689,256,433,1400000US17031292400,"Census Tract 2924,Cook County",17|031|292400,Illinois
515,1545,480,1065,1400000US17031292500,"Census Tract 2925,Cook County",17|031|292500,Illinois
516,946,421,525,1400000US17031300500,"Census Tract 3005,Cook County",17|031|300500,Illinois
517,877,281,596,1400000US17031300600,"Census Tract 3006,Cook County",17|031|300600,Illinois
518,1623,583,1040,1400000US17031300700,"Census Tract 3007,Cook County",17|031|300700,Illinois
519,1149,299,850,1400000US17031300800,"Census Tract 3008,Cook County",17|031|300800,Illinois
520,1531,738,793,1400000US17031300900,"Census Tract 3009,Cook County",17|031|300900,Illinois
521,749,244,505,1400000US17031301100,"Census Tract 3011,Cook County",17|031|301100,Illinois
522,1427,362,1065,1400000US17031301200,"Census Tract 3012,Cook County",17|031|301200,Illinois
523,1408,756,652,1400000US17031301600,"Census Tract 3016,Cook County",17|031|301600,Illinois
524,1300,752,548,1400000US17031301701,"Census Tract 3017,01,Cook County",17|031|301701,Illinois
525,1282,417,865,1400000US17031301702,"Census Tract 3017,02,Cook County",17|031|301702,Illinois
526,1164,418,746,1400000US17031301801,"Census Tract 3018,01,Cook County",17|031|301801,Illinois
527,802,295,507,1400000US17031301802,"Census Tract 3018,02,Cook County",17|031|301802,Illinois
528,1149,357,792,1400000US17031301803,"Census Tract 3018,03,Cook County",17|031|301803,Illinois
529,740,261,479,1400000US17031310200,"Census Tract 3102,Cook County",17|031|310200,Illinois
530,747,172,575,1400000US17031310300,"Census Tract 3103,Cook County",17|031|310300,Illinois
531,598,272,326,1400000US17031310400,"Census Tract 3104,Cook County",17|031|310400,Illinois
532,546,145,401,1400000US17031310500,"Census Tract 3105,Cook County",17|031|310500,Illinois
533,2289,599,1690,1400000US17031310600,"Census Tract 3106,Cook County",17|031|310600,Illinois
534,616,95,521,1400000US17031310700,"Census Tract 3107,Cook County",17|031|310700,Illinois
535,1622,480,1142,1400000US17031310800,"Census Tract 3108,Cook County",17|031|310800,Illinois
536,1769,641,1128,1400000US17031310900,"Census Tract 3109,Cook County",17|031|310900,Illinois
537,4937,2360,2577,1400000US17031320101,"Census Tract 3201,01,Cook County",17|031|320101,Illinois
538,2441,560,1881,1400000US17031320102,"Census Tract 3201,02,Cook County",17|031|320102,Illinois
539,773,482,291,1400000US17031320400,"Census Tract 3204,Cook County",17|031|320400,Illinois
540,3291,1196,2095,1400000US17031320600,"Census Tract 3206,Cook County",17|031|320600,Illinois
541,2661,1726,935,1400000US17031330101,"Census Tract 3301,01,Cook County",17|031|330101,Illinois
542,5874,2932,2942,1400000US17031330102,"Census Tract 3301,02,Cook County",17|031|330102,Illinois
543,4685,2180,2505,1400000US17031330103,"Census Tract 3301,03,Cook County",17|031|330103,Illinois
544,1866,1154,712,1400000US17031330200,"Census Tract 3302,Cook County",17|031|330200,Illinois
545,718,285,433,1400000US17031340300,"Census Tract 3403,Cook County",17|031|340300,Illinois
546,623,288,335,1400000US17031340400,"Census Tract 3404,Cook County",17|031|340400,Illinois
547,945,340,605,1400000US17031340500,"Census Tract 3405,Cook County",17|031|340500,Illinois
548,464,10,454,1400000US17031340600,"Census Tract 3406,Cook County",17|031|340600,Illinois
549,1501,0,1501,1400000US17031350100,"Census Tract 3501,Cook County",17|031|350100,Illinois
550,709,0,709,1400000US17031350400,"Census Tract 3504,Cook County",17|031|350400,Illinois
551,2322,159,2163,1400000US17031351000,"Census Tract 3510,Cook County",17|031|351000,Illinois
552,1101,16,1085,1400000US17031351100,"Census Tract 3511,Cook County",17|031|351100,Illinois
553,860,155,705,1400000US17031351400,"Census Tract 3514,Cook County",17|031|351400,Illinois
554,378,26,352,1400000US17031351500,"Census Tract 3515,Cook County",17|031|351500,Illinois
555,756,84,672,1400000US17031360200,"Census Tract 3602,Cook County",17|031|360200,Illinois
556,1137,536,601,1400000US17031380100,"Census Tract 3801,Cook County",17|031|380100,Illinois
557,1235,203,1032,1400000US17031380200,"Census Tract 3802,Cook County",17|031|380200,Illinois
558,2007,453,1554,1400000US17031380600,"Census Tract 3806,Cook County",17|031|380600,Illinois
559,960,193,767,1400000US17031381200,"Census Tract 3812,Cook County",17|031|381200,Illinois
560,722,136,586,1400000US17031381400,"Census Tract 3814,Cook County",17|031|381400,Illinois
561,367,56,311,1400000US17031381500,"Census Tract 3815,Cook County",17|031|381500,Illinois
562,0,0,0,1400000US17031381700,"Census Tract 3817,Cook County",17|031|381700,Illinois
563,735,163,572,1400000US17031381800,"Census Tract 3818,Cook County",17|031|381800,Illinois
564,543,301,242,1400000US17031381900,"Census Tract 3819,Cook County",17|031|381900,Illinois
565,733,265,468,1400000US17031390100,"Census Tract 3901,Cook County",17|031|390100,Illinois
566,921,596,325,1400000US17031390200,"Census Tract 3902,Cook County",17|031|390200,Illinois
567,1695,245,1450,1400000US17031390300,"Census Tract 3903,Cook County",17|031|390300,Illinois
568,1410,355,1055,1400000US17031390400,"Census Tract 3904,Cook County",17|031|390400,Illinois
569,875,237,638,1400000US17031390500,"Census Tract 3905,Cook County",17|031|390500,Illinois
570,845,319,526,1400000US17031390600,"Census Tract 3906,Cook County",17|031|390600,Illinois
571,3513,1411,2102,1400000US17031390700,"Census Tract 3907,Cook County",17|031|390700,Illinois
572,574,137,437,1400000US17031400300,"Census Tract 4003,Cook County",17|031|400300,Illinois
573,889,177,712,1400000US17031400400,"Census Tract 4004,Cook County",17|031|400400,Illinois
574,1067,154,913,1400000US17031400500,"Census Tract 4005,Cook County",17|031|400500,Illinois
575,1173,58,1115,1400000US17031400800,"Census Tract 4008,Cook County",17|031|400800,Illinois
576,1394,214,1180,1400000US17031410100,"Census Tract 4101,Cook County",17|031|410100,Illinois
577,770,144,626,1400000US17031410200,"Census Tract 4102,Cook County",17|031|410200,Illinois
578,1542,436,1106,1400000US17031410500,"Census Tract 4105,Cook County",17|031|410500,Illinois
579,1108,407,701,1400000US17031410600,"Census Tract 4106,Cook County",17|031|410600,Illinois
580,1122,326,796,1400000US17031410700,"Census Tract 4107,Cook County",17|031|410700,Illinois
581,1730,440,1290,1400000US17031410800,"Census Tract 4108,Cook County",17|031|410800,Illinois
582,1744,797,947,1400000US17031410900,"Census Tract 4109,Cook County",17|031|410900,Illinois
583,2235,1039,1196,1400000US17031411000,"Census Tract 4110,Cook County",17|031|411000,Illinois
584,930,442,488,1400000US17031411100,"Census Tract 4111,Cook County",17|031|411100,Illinois
585,764,459,305,1400000US17031411200,"Census Tract 4112,Cook County",17|031|411200,Illinois
586,861,15,846,1400000US17031420100,"Census Tract 4201,Cook County",17|031|420100,Illinois
587,681,92,589,1400000US17031420200,"Census Tract 4202,Cook County",17|031|420200,Illinois
588,677,142,535,1400000US17031420300,"Census Tract 4203,Cook County",17|031|420300,Illinois
589,671,85,586,1400000US17031420400,"Census Tract 4204,Cook County",17|031|420400,Illinois
590,925,196,729,1400000US17031420500,"Census Tract 4205,Cook County",17|031|420500,Illinois
591,933,149,784,1400000US17031420600,"Census Tract 4206,Cook County",17|031|420600,Illinois
592,1133,236,897,1400000US17031420700,"Census Tract 4207,Cook County",17|031|420700,Illinois
593,937,219,718,1400000US17031420800,"Census Tract 4208,Cook County",17|031|420800,Illinois
594,672,106,566,1400000US17031421200,"Census Tract 4212,Cook County",17|031|421200,Illinois
595,1712,258,1454,1400000US17031430101,"Census Tract 4301,01,Cook County",17|031|430101,Illinois
596,2417,422,1995,1400000US17031430102,"Census Tract 4301,02,Cook County",17|031|430102,Illinois
597,2723,548,2175,1400000US17031430200,"Census Tract 4302,Cook County",17|031|430200,Illinois
598,946,169,777,1400000US17031430300,"Census Tract 4303,Cook County",17|031|430300,Illinois
599,1335,556,779,1400000US17031430400,"Census Tract 4304,Cook County",17|031|430400,Illinois
600,1861,158,1703,1400000US17031430500,"Census Tract 4305,Cook County",17|031|430500,Illinois
601,821,267,554,1400000US17031430600,"Census Tract 4306,Cook County",17|031|430600,Illinois
602,1245,153,1092,1400000US17031430700,"Census Tract 4307,Cook County",17|031|430700,Illinois
603,809,279,530,1400000US17031430800,"Census Tract 4308,Cook County",17|031|430800,Illinois
604,840,264,576,1400000US17031430900,"Census Tract 4309,Cook County",17|031|430900,Illinois
605,1339,922,417,1400000US17031431200,"Census Tract 4312,Cook County",17|031|431200,Illinois
606,1414,260,1154,1400000US17031431301,"Census Tract 4313,01,Cook County",17|031|431301,Illinois
607,1379,101,1278,1400000US17031431302,"Census Tract 4313,02,Cook County",17|031|431302,Illinois
608,3395,511,2884,1400000US17031431400,"Census Tract 4314,Cook County",17|031|431400,Illinois
609,2375,151,2224,1400000US17031440101,"Census Tract 4401,01,Cook County",17|031|440101,Illinois
610,1838,420,1418,1400000US17031440102,"Census Tract 4401,02,Cook County",17|031|440102,Illinois
611,2495,512,1983,1400000US17031440201,"Census Tract 4402,01,Cook County",17|031|440201,Illinois
612,1490,587,903,1400000US17031440202,"Census Tract 4402,02,Cook County",17|031|440202,Illinois
613,2073,1351,722,1400000US17031440300,"Census Tract 4403,Cook County",17|031|440300,Illinois
614,738,578,160,1400000US17031440600,"Census Tract 4406,Cook County",17|031|440600,Illinois
615,586,462,124,1400000US17031440700,"Census Tract 4407,Cook County",17|031|440700,Illinois
616,661,191,470,1400000US17031440800,"Census Tract 4408,Cook County",17|031|440800,Illinois
617,976,602,374,1400000US17031440900,"Census Tract 4409,Cook County",17|031|440900,Illinois
618,1515,900,615,1400000US17031450300,"Census Tract 4503,Cook County",17|031|450300,Illinois
619,976,338,638,1400000US17031460100,"Census Tract 4601,Cook County",17|031|460100,Illinois
620,957,454,503,1400000US17031460200,"Census Tract 4602,Cook County",17|031|460200,Illinois
621,1152,566,586,1400000US17031460301,"Census Tract 4603,01,Cook County",17|031|460301,Illinois
622,1167,588,579,1400000US17031460302,"Census Tract 4603,02,Cook County",17|031|460302,Illinois
623,1303,642,661,1400000US17031460400,"Census Tract 4604,Cook County",17|031|460400,Illinois
624,2800,1563,1237,1400000US17031460500,"Census Tract 4605,Cook County",17|031|460500,Illinois
625,1341,386,955,1400000US17031460800,"Census Tract 4608,Cook County",17|031|460800,Illinois
626,732,67,665,1400000US17031461000,"Census Tract 4610,Cook County",17|031|461000,Illinois
627,1042,556,486,1400000US17031470100,"Census Tract 4701,Cook County",17|031|470100,Illinois
628,945,638,307,1400000US17031480100,"Census Tract 4801,Cook County",17|031|480100,Illinois
629,579,301,278,1400000US17031480200,"Census Tract 4802,Cook County",17|031|480200,Illinois
630,565,286,279,1400000US17031480300,"Census Tract 4803,Cook County",17|031|480300,Illinois
631,2301,2016,285,1400000US17031480400,"Census Tract 4804,Cook County",17|031|480400,Illinois
632,1193,788,405,1400000US17031480500,"Census Tract 4805,Cook County",17|031|480500,Illinois
633,1422,885,537,1400000US17031490200,"Census Tract 4902,Cook County",17|031|490200,Illinois
634,757,568,189,1400000US17031490500,"Census Tract 4905,Cook County",17|031|490500,Illinois
635,551,401,150,1400000US17031490600,"Census Tract 4906,Cook County",17|031|490600,Illinois
636,936,668,268,1400000US17031490700,"Census Tract 4907,Cook County",17|031|490700,Illinois
637,1256,743,513,1400000US17031490800,"Census Tract 4908,Cook County",17|031|490800,Illinois
638,1192,413,779,1400000US17031490901,"Census Tract 4909,01,Cook County",17|031|490901,Illinois
639,1754,1017,737,1400000US17031490902,"Census Tract 4909,02,Cook County",17|031|490902,Illinois
640,1112,486,626,1400000US17031491000,"Census Tract 4910,Cook County",17|031|491000,Illinois
641,1348,1017,331,1400000US17031491100,"Census Tract 4911,Cook County",17|031|491100,Illinois
642,646,422,224,1400000US17031491200,"Census Tract 4912,Cook County",17|031|491200,Illinois
643,649,255,394,1400000US17031491300,"Census Tract 4913,Cook County",17|031|491300,Illinois
644,1145,218,927,1400000US17031491400,"Census Tract 4914,Cook County",17|031|491400,Illinois
645,1585,828,757,1400000US17031500100,"Census Tract 5001,Cook County",17|031|500100,Illinois
646,799,346,453,1400000US17031500200,"Census Tract 5002,Cook County",17|031|500200,Illinois
647,905,444,461,1400000US17031500300,"Census Tract 5003,Cook County",17|031|500300,Illinois
648,1261,695,566,1400000US17031510100,"Census Tract 5101,Cook County",17|031|510100,Illinois
649,1267,856,411,1400000US17031510200,"Census Tract 5102,Cook County",17|031|510200,Illinois
650,1866,794,1072,1400000US17031510300,"Census Tract 5103,Cook County",17|031|510300,Illinois
651,510,262,248,1400000US17031520100,"Census Tract 5201,Cook County",17|031|520100,Illinois
652,1140,492,648,1400000US17031520200,"Census Tract 5202,Cook County",17|031|520200,Illinois
653,1923,1235,688,1400000US17031520300,"Census Tract 5203,Cook County",17|031|520300,Illinois
654,1462,1090,372,1400000US17031520400,"Census Tract 5204,Cook County",17|031|520400,Illinois
655,1520,1229,291,1400000US17031520500,"Census Tract 5205,Cook County",17|031|520500,Illinois
656,778,647,131,1400000US17031520600,"Census Tract 5206,Cook County",17|031|520600,Illinois
657,810,267,543,1400000US17031530100,"Census Tract 5301,Cook County",17|031|530100,Illinois
658,1400,757,643,1400000US17031530200,"Census Tract 5302,Cook County",17|031|530200,Illinois
659,1551,953,598,1400000US17031530300,"Census Tract 5303,Cook County",17|031|530300,Illinois
660,801,587,214,1400000US17031530400,"Census Tract 5304,Cook County",17|031|530400,Illinois
661,1739,981,758,1400000US17031530501,"Census Tract 5305,01,Cook County",17|031|530501,Illinois
662,570,521,49,1400000US17031530502,"Census Tract 5305,02,Cook County",17|031|530502,Illinois
663,1554,1177,377,1400000US17031530503,"Census Tract 5305,03,Cook County",17|031|530503,Illinois
664,900,448,452,1400000US17031530600,"Census Tract 5306,Cook County",17|031|530600,Illinois
665,1661,88,1573,1400000US17031540101,"Census Tract 5401,01,Cook County",17|031|540101,Illinois
666,1244,167,1077,1400000US17031540102,"Census Tract 5401,02,Cook County",17|031|540102,Illinois
667,2717,1679,1038,1400000US17031550100,"Census Tract 5501,Cook County",17|031|550100,Illinois
668,1076,839,237,1400000US17031550200,"Census Tract 5502,Cook County",17|031|550200,Illinois
669,361,244,117,1400000US17031560100,"Census Tract 5601,Cook County",17|031|560100,Illinois
670,562,453,109,1400000US17031560200,"Census Tract 5602,Cook County",17|031|560200,Illinois
671,1048,981,67,1400000US17031560300,"Census Tract 5603,Cook County",17|031|560300,Illinois
672,480,451,29,1400000US17031560400,"Census Tract 5604,Cook County",17|031|560400,Illinois
673,1312,884,428,1400000US17031560700,"Census Tract 5607,Cook County",17|031|560700,Illinois
674,2007,1653,354,1400000US17031560800,"Census Tract 5608,Cook County",17|031|560800,Illinois
675,1860,1748,112,1400000US17031560900,"Census Tract 5609,Cook County",17|031|560900,Illinois
676,2285,1996,289,1400000US17031561000,"Census Tract 5610,Cook County",17|031|561000,Illinois
677,2185,2038,147,1400000US17031561100,"Census Tract 5611,Cook County",17|031|561100,Illinois
678,446,341,105,1400000US17031570100,"Census Tract 5701,Cook County",17|031|570100,Illinois
679,824,509,315,1400000US17031570200,"Census Tract 5702,Cook County",17|031|570200,Illinois
680,1755,1243,512,1400000US17031570300,"Census Tract 5703,Cook County",17|031|570300,Illinois
681,584,284,300,1400000US17031570400,"Census Tract 5704,Cook County",17|031|570400,Illinois
682,756,474,282,1400000US17031570500,"Census Tract 5705,Cook County",17|031|570500,Illinois
683,934,571,363,1400000US17031580100,"Census Tract 5801,Cook County",17|031|580100,Illinois
684,846,424,422,1400000US17031580200,"Census Tract 5802,Cook County",17|031|580200,Illinois
685,750,453,297,1400000US17031580300,"Census Tract 5803,Cook County",17|031|580300,Illinois
686,1482,900,582,1400000US17031580400,"Census Tract 5804,Cook County",17|031|580400,Illinois
687,1534,634,900,1400000US17031580501,"Census Tract 5805,01,Cook County",17|031|580501,Illinois
688,1437,675,762,1400000US17031580502,"Census Tract 5805,02,Cook County",17|031|580502,Illinois
689,1587,824,763,1400000US17031580600,"Census Tract 5806,Cook County",17|031|580600,Illinois
690,1669,841,828,1400000US17031580700,"Census Tract 5807,Cook County",17|031|580700,Illinois
691,537,323,214,1400000US17031580800,"Census Tract 5808,Cook County",17|031|580800,Illinois
692,713,483,230,1400000US17031590500,"Census Tract 5905,Cook County",17|031|590500,Illinois
693,1361,791,570,1400000US17031590600,"Census Tract 5906,Cook County",17|031|590600,Illinois
694,1042,577,465,1400000US17031590700,"Census Tract 5907,Cook County",17|031|590700,Illinois
695,1637,766,871,1400000US17031600400,"Census Tract 6004,Cook County",17|031|600400,Illinois
696,1188,664,524,1400000US17031600600,"Census Tract 6006,Cook County",17|031|600600,Illinois
697,1140,498,642,1400000US17031600700,"Census Tract 6007,Cook County",17|031|600700,Illinois
698,1356,556,800,1400000US17031600900,"Census Tract 6009,Cook County",17|031|600900,Illinois
699,2059,688,1371,1400000US17031610300,"Census Tract 6103,Cook County",17|031|610300,Illinois
700,566,167,399,1400000US17031610400,"Census Tract 6104,Cook County",17|031|610400,Illinois
701,568,362,206,1400000US17031610800,"Census Tract 6108,Cook County",17|031|610800,Illinois
702,796,285,511,1400000US17031611200,"Census Tract 6112,Cook County",17|031|611200,Illinois
703,1017,187,830,1400000US17031611300,"Census Tract 6113,Cook County",17|031|611300,Illinois
704,927,244,683,1400000US17031611400,"Census Tract 6114,Cook County",17|031|611400,Illinois
705,974,296,678,1400000US17031611500,"Census Tract 6115,Cook County",17|031|611500,Illinois
706,500,178,322,1400000US17031611600,"Census Tract 6116,Cook County",17|031|611600,Illinois
707,754,183,571,1400000US17031611700,"Census Tract 6117,Cook County",17|031|611700,Illinois
708,662,204,458,1400000US17031611800,"Census Tract 6118,Cook County",17|031|611800,Illinois
709,510,192,318,1400000US17031611900,"Census Tract 6119,Cook County",17|031|611900,Illinois
710,483,189,294,1400000US17031612000,"Census Tract 6120,Cook County",17|031|612000,Illinois
711,356,111,245,1400000US17031612100,"Census Tract 6121,Cook County",17|031|612100,Illinois
712,1127,317,810,1400000US17031612200,"Census Tract 6122,Cook County",17|031|612200,Illinois
713,1204,992,212,1400000US17031620100,"Census Tract 6201,Cook County",17|031|620100,Illinois
714,758,481,277,1400000US17031620200,"Census Tract 6202,Cook County",17|031|620200,Illinois
715,2210,1519,691,1400000US17031620300,"Census Tract 6203,Cook County",17|031|620300,Illinois
716,1293,954,339,1400000US17031620400,"Census Tract 6204,Cook County",17|031|620400,Illinois
717,1431,687,744,1400000US17031630300,"Census Tract 6303,Cook County",17|031|630300,Illinois
718,1792,987,805,1400000US17031630400,"Census Tract 6304,Cook County",17|031|630400,Illinois
719,1605,709,896,1400000US17031630500,"Census Tract 6305,Cook County",17|031|630500,Illinois
720,836,445,391,1400000US17031630600,"Census Tract 6306,Cook County",17|031|630600,Illinois
721,1723,1227,496,1400000US17031630800,"Census Tract 6308,Cook County",17|031|630800,Illinois
722,1448,680,768,1400000US17031630900,"Census Tract 6309,Cook County",17|031|630900,Illinois
723,469,244,225,1400000US17031640100,"Census Tract 6401,Cook County",17|031|640100,Illinois
724,2458,1511,947,1400000US17031640300,"Census Tract 6403,Cook County",17|031|640300,Illinois
725,1169,1096,73,1400000US17031640400,"Census Tract 6404,Cook County",17|031|640400,Illinois
726,1562,1131,431,1400000US17031640500,"Census Tract 6405,Cook County",17|031|640500,Illinois
727,1770,1086,684,1400000US17031640600,"Census Tract 6406,Cook County",17|031|640600,Illinois
728,1019,782,237,1400000US17031640700,"Census Tract 6407,Cook County",17|031|640700,Illinois
729,575,428,147,1400000US17031640800,"Census Tract 6408,Cook County",17|031|640800,Illinois
730,1409,724,685,1400000US17031650100,"Census Tract 6501,Cook County",17|031|650100,Illinois
731,2139,1159,980,1400000US17031650200,"Census Tract 6502,Cook County",17|031|650200,Illinois
732,1584,1254,330,1400000US17031650301,"Census Tract 6503,01,Cook County",17|031|650301,Illinois
733,1229,906,323,1400000US17031650302,"Census Tract 6503,02,Cook County",17|031|650302,Illinois
734,1623,1368,255,1400000US17031650400,"Census Tract 6504,Cook County",17|031|650400,Illinois
735,1546,1291,255,1400000US17031650500,"Census Tract 6505,Cook County",17|031|650500,Illinois
736,583,139,444,1400000US17031660301,"Census Tract 6603,01,Cook County",17|031|660301,Illinois
737,1463,449,1014,1400000US17031660302,"Census Tract 6603,02,Cook County",17|031|660302,Illinois
738,1469,882,587,1400000US17031660400,"Census Tract 6604,Cook County",17|031|660400,Illinois
739,1374,646,728,1400000US17031660500,"Census Tract 6605,Cook County",17|031|660500,Illinois
740,1942,625,1317,1400000US17031660600,"Census Tract 6606,Cook County",17|031|660600,Illinois
741,642,291,351,1400000US17031660700,"Census Tract 6607,Cook County",17|031|660700,Illinois
742,2147,689,1458,1400000US17031660800,"Census Tract 6608,Cook County",17|031|660800,Illinois
743,1577,501,1076,1400000US17031660900,"Census Tract 6609,Cook County",17|031|660900,Illinois
744,2122,1250,872,1400000US17031661000,"Census Tract 6610,Cook County",17|031|661000,Illinois
745,1910,1549,361,1400000US17031661100,"Census Tract 6611,Cook County",17|031|661100,Illinois
746,430,200,230,1400000US17031670100,"Census Tract 6701,Cook County",17|031|670100,Illinois
747,366,106,260,1400000US17031670200,"Census Tract 6702,Cook County",17|031|670200,Illinois
748,448,160,288,1400000US17031670300,"Census Tract 6703,Cook County",17|031|670300,Illinois
749,599,246,353,1400000US17031670400,"Census Tract 6704,Cook County",17|031|670400,Illinois
750,374,129,245,1400000US17031670500,"Census Tract 6705,Cook County",17|031|670500,Illinois
751,365,221,144,1400000US17031670600,"Census Tract 6706,Cook County",17|031|670600,Illinois
752,319,138,181,1400000US17031670700,"Census Tract 6707,Cook County",17|031|670700,Illinois
753,472,151,321,1400000US17031670800,"Census Tract 6708,Cook County",17|031|670800,Illinois
754,561,294,267,1400000US17031670900,"Census Tract 6709,Cook County",17|031|670900,Illinois
755,404,138,266,1400000US17031671100,"Census Tract 6711,Cook County",17|031|671100,Illinois
756,274,105,169,1400000US17031671200,"Census Tract 6712,Cook County",17|031|671200,Illinois
757,699,349,350,1400000US17031671300,"Census Tract 6713,Cook County",17|031|671300,Illinois
758,542,427,115,1400000US17031671400,"Census Tract 6714,Cook County",17|031|671400,Illinois
759,903,428,475,1400000US17031671500,"Census Tract 6715,Cook County",17|031|671500,Illinois
760,670,128,542,1400000US17031671600,"Census Tract 6716,Cook County",17|031|671600,Illinois
761,394,199,195,1400000US17031671800,"Census Tract 6718,Cook County",17|031|671800,Illinois
762,339,196,143,1400000US17031671900,"Census Tract 6719,Cook County",17|031|671900,Illinois
763,1018,715,303,1400000US17031672000,"Census Tract 6720,Cook County",17|031|672000,Illinois
764,501,182,319,1400000US17031680500,"Census Tract 6805,Cook County",17|031|680500,Illinois
765,434,99,335,1400000US17031680600,"Census Tract 6806,Cook County",17|031|680600,Illinois
766,1994,218,1776,1400000US17031680900,"Census Tract 6809,Cook County",17|031|680900,Illinois
767,976,347,629,1400000US17031681000,"Census Tract 6810,Cook County",17|031|681000,Illinois
768,765,291,474,1400000US17031681100,"Census Tract 6811,Cook County",17|031|681100,Illinois
769,798,133,665,1400000US17031681200,"Census Tract 6812,Cook County",17|031|681200,Illinois
770,860,149,711,1400000US17031681300,"Census Tract 6813,Cook County",17|031|681300,Illinois
771,683,311,372,1400000US17031681400,"Census Tract 6814,Cook County",17|031|681400,Illinois
772,754,80,674,1400000US17031690300,"Census Tract 6903,Cook County",17|031|690300,Illinois
773,1438,367,1071,1400000US17031690400,"Census Tract 6904,Cook County",17|031|690400,Illinois
774,348,174,174,1400000US17031690500,"Census Tract 6905,Cook County",17|031|690500,Illinois
775,1853,753,1100,1400000US17031690900,"Census Tract 6909,Cook County",17|031|690900,Illinois
776,1111,530,581,1400000US17031691000,"Census Tract 6910,Cook County",17|031|691000,Illinois
777,891,331,560,1400000US17031691100,"Census Tract 6911,Cook County",17|031|691100,Illinois
778,881,328,553,1400000US17031691200,"Census Tract 6912,Cook County",17|031|691200,Illinois
779,1130,488,642,1400000US17031691300,"Census Tract 6913,Cook County",17|031|691300,Illinois
780,1270,589,681,1400000US17031691400,"Census Tract 6914,Cook County",17|031|691400,Illinois
781,884,252,632,1400000US17031691500,"Census Tract 6915,Cook County",17|031|691500,Illinois
782,1046,886,160,1400000US17031700100,"Census Tract 7001,Cook County",17|031|700100,Illinois
783,1882,1641,241,1400000US17031700200,"Census Tract 7002,Cook County",17|031|700200,Illinois
784,1898,1651,247,1400000US17031700301,"Census Tract 7003,01,Cook County",17|031|700301,Illinois
785,1812,1547,265,1400000US17031700302,"Census Tract 7003,02,Cook County",17|031|700302,Illinois
786,1926,1524,402,1400000US17031700401,"Census Tract 7004,01,Cook County",17|031|700401,Illinois
787,1189,1100,89,1400000US17031700402,"Census Tract 7004,02,Cook County",17|031|700402,Illinois
788,2512,1889,623,1400000US17031700501,"Census Tract 7005,01,Cook County",17|031|700501,Illinois
789,1177,1016,161,1400000US17031700502,"Census Tract 7005,02,Cook County",17|031|700502,Illinois
790,541,126,415,1400000US17031710100,"Census Tract 7101,Cook County",17|031|710100,Illinois
791,1733,513,1220,1400000US17031710200,"Census Tract 7102,Cook County",17|031|710200,Illinois
792,527,191,336,1400000US17031710300,"Census Tract 7103,Cook County",17|031|710300,Illinois
793,2168,1099,1069,1400000US17031710400,"Census Tract 7104,Cook County",17|031|710400,Illinois
794,1503,603,900,1400000US17031710500,"Census Tract 7105,Cook County",17|031|710500,Illinois
795,919,327,592,1400000US17031710600,"Census Tract 7106,Cook County",17|031|710600,Illinois
796,1346,482,864,1400000US17031710700,"Census Tract 7107,Cook County",17|031|710700,Illinois
797,1938,523,1415,1400000US17031710800,"Census Tract 7108,Cook County",17|031|710800,Illinois
798,774,342,432,1400000US17031710900,"Census Tract 7109,Cook County",17|031|710900,Illinois
799,1161,569,592,1400000US17031711000,"Census Tract 7110,Cook County",17|031|711000,Illinois
800,935,669,266,1400000US17031711100,"Census Tract 7111,Cook County",17|031|711100,Illinois
801,1766,1267,499,1400000US17031711200,"Census Tract 7112,Cook County",17|031|711200,Illinois
802,677,294,383,1400000US17031711300,"Census Tract 7113,Cook County",17|031|711300,Illinois
803,850,513,337,1400000US17031711400,"Census Tract 7114,Cook County",17|031|711400,Illinois
804,871,628,243,1400000US17031711500,"Census Tract 7115,Cook County",17|031|711500,Illinois
805,1092,1081,11,1400000US17031720100,"Census Tract 7201,Cook County",17|031|720100,Illinois
806,1614,1306,308,1400000US17031720200,"Census Tract 7202,Cook County",17|031|720200,Illinois
807,1501,1384,117,1400000US17031720300,"Census Tract 7203,Cook County",17|031|720300,Illinois
808,684,636,48,1400000US17031720400,"Census Tract 7204,Cook County",17|031|720400,Illinois
809,728,670,58,1400000US17031720500,"Census Tract 7205,Cook County",17|031|720500,Illinois
810,631,575,56,1400000US17031720600,"Census Tract 7206,Cook County",17|031|720600,Illinois
811,1172,679,493,1400000US17031720700,"Census Tract 7207,Cook County",17|031|720700,Illinois
812,929,813,116,1400000US17031730100,"Census Tract 7301,Cook County",17|031|730100,Illinois
813,2077,813,1264,1400000US17031730201,"Census Tract 7302,01,Cook County",17|031|730201,Illinois
814,1007,724,283,1400000US17031730202,"Census Tract 7302,02,Cook County",17|031|730202,Illinois
815,386,262,124,1400000US17031730300,"Census Tract 7303,Cook County",17|031|730300,Illinois
816,1432,1021,411,1400000US17031730400,"Census Tract 7304,Cook County",17|031|730400,Illinois
817,1769,1461,308,1400000US17031730500,"Census Tract 7305,Cook County",17|031|730500,Illinois
818,1094,766,328,1400000US17031730600,"Census Tract 7306,Cook County",17|031|730600,Illinois
819,788,624,164,1400000US17031730700,"Census Tract 7307,Cook County",17|031|730700,Illinois
820,1199,1003,196,1400000US17031740100,"Census Tract 7401,Cook County",17|031|740100,Illinois
821,2087,1753,334,1400000US17031740200,"Census Tract 7402,Cook County",17|031|740200,Illinois
822,1939,1745,194,1400000US17031740300,"Census Tract 7403,Cook County",17|031|740300,Illinois
823,1883,1389,494,1400000US17031740400,"Census Tract 7404,Cook County",17|031|740400,Illinois
824,1495,1021,474,1400000US17031750100,"Census Tract 7501,Cook County",17|031|750100,Illinois
825,1389,830,559,1400000US17031750200,"Census Tract 7502,Cook County",17|031|750200,Illinois
826,971,788,183,1400000US17031750300,"Census Tract 7503,Cook County",17|031|750300,Illinois
827,1302,1108,194,1400000US17031750400,"Census Tract 7504,Cook County",17|031|750400,Illinois
828,1942,1181,761,1400000US17031750500,"Census Tract 7505,Cook County",17|031|750500,Illinois
829,1256,932,324,1400000US17031750600,"Census Tract 7506,Cook County",17|031|750600,Illinois
830,2380,397,1983,1400000US17031760801,"Census Tract 7608,01,Cook County",17|031|760801,Illinois
831,1207,1021,186,1400000US17031760802,"Census Tract 7608,02,Cook County",17|031|760802,Illinois
832,2986,1238,1748,1400000US17031760803,"Census Tract 7608,03,Cook County",17|031|760803,Illinois
833,2699,1386,1313,1400000US17031770201,"Census Tract 7702,01,Cook County",17|031|770201,Illinois
834,1927,1778,149,1400000US17031770202,"Census Tract 7702,02,Cook County",17|031|770202,Illinois
835,2683,1814,869,1400000US17031770300,"Census Tract 7703,Cook County",17|031|770300,Illinois
836,1587,986,601,1400000US17031770400,"Census Tract 7704,Cook County",17|031|770400,Illinois
837,1138,919,219,1400000US17031770500,"Census Tract 7705,Cook County",17|031|770500,Illinois
838,1141,1035,106,1400000US17031770601,"Census Tract 7706,01,Cook County",17|031|770601,Illinois
839,1556,752,804,1400000US17031770602,"Census Tract 7706,02,Cook County",17|031|770602,Illinois
840,1026,333,693,1400000US17031770700,"Census Tract 7707,Cook County",17|031|770700,Illinois
841,2009,1373,636,1400000US17031770800,"Census Tract 7708,Cook County",17|031|770800,Illinois
842,1973,1617,356,1400000US17031770901,"Census Tract 7709,01,Cook County",17|031|770901,Illinois
843,1465,980,485,1400000US17031770902,"Census Tract 7709,02,Cook County",17|031|770902,Illinois
844,836,805,31,1400000US17031800100,"Census Tract 8001,Cook County",17|031|800100,Illinois
845,2359,2180,179,1400000US17031800200,"Census Tract 8002,Cook County",17|031|800200,Illinois
846,1166,1068,98,1400000US17031800300,"Census Tract 8003,Cook County",17|031|800300,Illinois
847,1288,1155,133,1400000US17031800400,"Census Tract 8004,Cook County",17|031|800400,Illinois
848,1878,1697,181,1400000US17031800500,"Census Tract 8005,Cook County",17|031|800500,Illinois
849,700,679,21,1400000US17031800600,"Census Tract 8006,Cook County",17|031|800600,Illinois
850,1719,1604,115,1400000US17031800700,"Census Tract 8007,Cook County",17|031|800700,Illinois
851,973,847,126,1400000US17031800800,"Census Tract 8008,Cook County",17|031|800800,Illinois
852,1645,1524,121,1400000US17031800900,"Census Tract 8009,Cook County",17|031|800900,Illinois
853,2158,1795,363,1400000US17031801000,"Census Tract 8010,Cook County",17|031|801000,Illinois
854,1600,1473,127,1400000US17031801100,"Census Tract 8011,Cook County",17|031|801100,Illinois
855,1444,1366,78,1400000US17031801200,"Census Tract 8012,Cook County",17|031|801200,Illinois
856,1738,1302,436,1400000US17031801300,"Census Tract 8013,Cook County",17|031|801300,Illinois
857,1148,1108,40,1400000US17031801400,"Census Tract 8014,Cook County",17|031|801400,Illinois
858,2611,2154,457,1400000US17031801500,"Census Tract 8015,Cook County",17|031|801500,Illinois
859,1894,1451,443,1400000US17031801601,"Census Tract 8016,01,Cook County",17|031|801601,Illinois
860,1527,620,907,1400000US17031801603,"Census Tract 8016,03,Cook County",17|031|801603,Illinois
861,2118,2080,38,1400000US17031801605,"Census Tract 8016,05,Cook County",17|031|801605,Illinois
862,2824,2443,381,1400000US17031801606,"Census Tract 8016,06,Cook County",17|031|801606,Illinois
863,2025,1592,433,1400000US17031801607,"Census Tract 8016,07,Cook County",17|031|801607,Illinois
864,2797,2152,645,1400000US17031801608,"Census Tract 8016,08,Cook County",17|031|801608,Illinois
865,1194,1152,42,1400000US17031801701,"Census Tract 8017,01,Cook County",17|031|801701,Illinois
866,1760,1546,214,1400000US17031801702,"Census Tract 8017,02,Cook County",17|031|801702,Illinois
867,2425,2211,214,1400000US17031801800,"Census Tract 8018,Cook County",17|031|801800,Illinois
868,1948,1587,361,1400000US17031801901,"Census Tract 8019,01,Cook County",17|031|801901,Illinois
869,1241,1174,67,1400000US17031801902,"Census Tract 8019,02,Cook County",17|031|801902,Illinois
870,1681,1564,117,1400000US17031802002,"Census Tract 8020,02,Cook County",17|031|802002,Illinois
871,801,712,89,1400000US17031802003,"Census Tract 8020,03,Cook County",17|031|802003,Illinois
872,2383,1414,969,1400000US17031802004,"Census Tract 8020,04,Cook County",17|031|802004,Illinois
873,1182,922,260,1400000US17031802100,"Census Tract 8021,Cook County",17|031|802100,Illinois
874,1962,1689,273,1400000US17031802200,"Census Tract 8022,Cook County",17|031|802200,Illinois
875,2586,1417,1169,1400000US17031802300,"Census Tract 8023,Cook County",17|031|802300,Illinois
876,2424,1547,877,1400000US17031802402,"Census Tract 8024,02,Cook County",17|031|802402,Illinois
877,848,724,124,1400000US17031802403,"Census Tract 8024,03,Cook County",17|031|802403,Illinois
878,3122,2041,1081,1400000US17031802404,"Census Tract 8024,04,Cook County",17|031|802404,Illinois
879,2628,1970,658,1400000US17031802503,"Census Tract 8025,03,Cook County",17|031|802503,Illinois
880,2054,1812,242,1400000US17031802504,"Census Tract 8025,04,Cook County",17|031|802504,Illinois
881,2496,916,1580,1400000US17031802505,"Census Tract 8025,05,Cook County",17|031|802505,Illinois
882,785,528,257,1400000US17031802506,"Census Tract 8025,06,Cook County",17|031|802506,Illinois
883,3086,2352,734,1400000US17031802605,"Census Tract 8026,05,Cook County",17|031|802605,Illinois
884,432,398,34,1400000US17031802607,"Census Tract 8026,07,Cook County",17|031|802607,Illinois
885,2945,2502,443,1400000US17031802608,"Census Tract 8026,08,Cook County",17|031|802608,Illinois
886,2740,1262,1478,1400000US17031802609,"Census Tract 8026,09,Cook County",17|031|802609,Illinois
887,783,736,47,1400000US17031802610,"Census Tract 8026,10,Cook County",17|031|802610,Illinois
888,2240,1945,295,1400000US17031802701,"Census Tract 8027,01,Cook County",17|031|802701,Illinois
889,1715,1316,399,1400000US17031802702,"Census Tract 8027,02,Cook County",17|031|802702,Illinois
890,1873,1655,218,1400000US17031802801,"Census Tract 8028,01,Cook County",17|031|802801,Illinois
891,2356,1952,404,1400000US17031802802,"Census Tract 8028,02,Cook County",17|031|802802,Illinois
892,2086,1982,104,1400000US17031802900,"Census Tract 8029,Cook County",17|031|802900,Illinois
893,1214,925,289,1400000US17031803005,"Census Tract 8030,05,Cook County",17|031|803005,Illinois
894,2164,1713,451,1400000US17031803007,"Census Tract 8030,07,Cook County",17|031|803007,Illinois
895,1717,1556,161,1400000US17031803008,"Census Tract 8030,08,Cook County",17|031|803008,Illinois
896,1741,1668,73,1400000US17031803010,"Census Tract 8030,10,Cook County",17|031|803010,Illinois
897,981,569,412,1400000US17031803012,"Census Tract 8030,12,Cook County",17|031|803012,Illinois
898,2344,2056,288,1400000US17031803013,"Census Tract 8030,13,Cook County",17|031|803013,Illinois
899,1417,937,480,1400000US17031803014,"Census Tract 8030,14,Cook County",17|031|803014,Illinois
900,1962,1566,396,1400000US17031803015,"Census Tract 8030,15,Cook County",17|031|803015,Illinois
901,931,439,492,1400000US17031803016,"Census Tract 8030,16,Cook County",17|031|803016,Illinois
902,2560,1436,1124,1400000US17031803017,"Census Tract 8030,17,Cook County",17|031|803017,Illinois
903,1179,1121,58,1400000US17031803100,"Census Tract 8031,Cook County",17|031|803100,Illinois
904,2172,1757,415,1400000US17031803200,"Census Tract 8032,Cook County",17|031|803200,Illinois
905,2993,1752,1241,1400000US17031803300,"Census Tract 8033,Cook County",17|031|803300,Illinois
906,2289,1824,465,1400000US17031803400,"Census Tract 8034,Cook County",17|031|803400,Illinois
907,2222,1876,346,1400000US17031803500,"Census Tract 8035,Cook County",17|031|803500,Illinois
908,2228,2069,159,1400000US17031803603,"Census Tract 8036,03,Cook County",17|031|803603,Illinois
909,1783,1207,576,1400000US17031803604,"Census Tract 8036,04,Cook County",17|031|803604,Illinois
910,2560,1991,569,1400000US17031803605,"Census Tract 8036,05,Cook County",17|031|803605,Illinois
911,1654,1453,201,1400000US17031803607,"Census Tract 8036,07,Cook County",17|031|803607,Illinois
912,3230,1476,1754,1400000US17031803608,"Census Tract 8036,08,Cook County",17|031|803608,Illinois
913,2129,1401,728,1400000US17031803611,"Census Tract 8036,11,Cook County",17|031|803611,Illinois
914,1404,311,1093,1400000US17031803612,"Census Tract 8036,12,Cook County",17|031|803612,Illinois
915,1059,523,536,1400000US17031803613,"Census Tract 8036,13,Cook County",17|031|803613,Illinois
916,1603,393,1210,1400000US17031803614,"Census Tract 8036,14,Cook County",17|031|803614,Illinois
917,1027,576,451,1400000US17031803615,"Census Tract 8036,15,Cook County",17|031|803615,Illinois
918,2013,1367,646,1400000US17031803616,"Census Tract 8036,16,Cook County",17|031|803616,Illinois
919,1318,806,512,1400000US17031803701,"Census Tract 8037,01,Cook County",17|031|803701,Illinois
920,2489,1691,798,1400000US17031803702,"Census Tract 8037,02,Cook County",17|031|803702,Illinois
921,1740,1428,312,1400000US17031803800,"Census Tract 8038,Cook County",17|031|803800,Illinois
922,1987,1523,464,1400000US17031803901,"Census Tract 8039,01,Cook County",17|031|803901,Illinois
923,1275,1147,128,1400000US17031803902,"Census Tract 8039,02,Cook County",17|031|803902,Illinois
924,1999,1819,180,1400000US17031804000,"Census Tract 8040,Cook County",17|031|804000,Illinois
925,2481,2388,93,1400000US17031804102,"Census Tract 8041,02,Cook County",17|031|804102,Illinois
926,1814,1540,274,1400000US17031804104,"Census Tract 8041,04,Cook County",17|031|804104,Illinois
927,1449,1427,22,1400000US17031804105,"Census Tract 8041,05,Cook County",17|031|804105,Illinois
928,2658,2303,355,1400000US17031804106,"Census Tract 8041,06,Cook County",17|031|804106,Illinois
929,2275,273,2002,1400000US17031804108,"Census Tract 8041,08,Cook County",17|031|804108,Illinois
930,1177,1038,139,1400000US17031804109,"Census Tract 8041,09,Cook County",17|031|804109,Illinois
931,2830,2404,426,1400000US17031804202,"Census Tract 8042,02,Cook County",17|031|804202,Illinois
932,1017,1017,0,1400000US17031804203,"Census Tract 8042,03,Cook County",17|031|804203,Illinois
933,1912,1658,254,1400000US17031804204,"Census Tract 8042,04,Cook County",17|031|804204,Illinois
934,2654,2198,456,1400000US17031804305,"Census Tract 8043,05,Cook County",17|031|804305,Illinois
935,1806,1596,210,1400000US17031804306,"Census Tract 8043,06,Cook County",17|031|804306,Illinois
936,2198,1653,545,1400000US17031804308,"Census Tract 8043,08,Cook County",17|031|804308,Illinois
937,958,782,176,1400000US17031804309,"Census Tract 8043,09,Cook County",17|031|804309,Illinois
938,644,587,57,1400000US17031804312,"Census Tract 8043,12,Cook County",17|031|804312,Illinois
939,2187,1629,558,1400000US17031804313,"Census Tract 8043,13,Cook County",17|031|804313,Illinois
940,631,521,110,1400000US17031804314,"Census Tract 8043,14,Cook County",17|031|804314,Illinois
941,854,741,113,1400000US17031804315,"Census Tract 8043,15,Cook County",17|031|804315,Illinois
942,1618,1545,73,1400000US17031804316,"Census Tract 8043,16,Cook County",17|031|804316,Illinois
943,2532,1746,786,1400000US17031804403,"Census Tract 8044,03,Cook County",17|031|804403,Illinois
944,1619,1395,224,1400000US17031804404,"Census Tract 8044,04,Cook County",17|031|804404,Illinois
945,1018,410,608,1400000US17031804405,"Census Tract 8044,05,Cook County",17|031|804405,Illinois
946,1844,1568,276,1400000US17031804406,"Census Tract 8044,06,Cook County",17|031|804406,Illinois
947,1463,880,583,1400000US17031804505,"Census Tract 8045,05,Cook County",17|031|804505,Illinois
948,1919,1578,341,1400000US17031804506,"Census Tract 8045,06,Cook County",17|031|804506,Illinois
949,808,330,478,1400000US17031804508,"Census Tract 8045,08,Cook County",17|031|804508,Illinois
950,1616,1211,405,1400000US17031804509,"Census Tract 8045,09,Cook County",17|031|804509,Illinois
951,1371,913,458,1400000US17031804510,"Census Tract 8045,10,Cook County",17|031|804510,Illinois
952,714,329,385,1400000US17031804511,"Census Tract 8045,11,Cook County",17|031|804511,Illinois
953,1325,1259,66,1400000US17031804512,"Census Tract 8045,12,Cook County",17|031|804512,Illinois
954,1419,1195,224,1400000US17031804513,"Census Tract 8045,13,Cook County",17|031|804513,Illinois
955,1653,1303,350,1400000US17031804514,"Census Tract 8045,14,Cook County",17|031|804514,Illinois
956,2863,914,1949,1400000US17031804603,"Census Tract 8046,03,Cook County",17|031|804603,Illinois
957,2428,2332,96,1400000US17031804606,"Census Tract 8046,06,Cook County",17|031|804606,Illinois
958,2614,1910,704,1400000US17031804607,"Census Tract 8046,07,Cook County",17|031|804607,Illinois
959,1554,1154,400,1400000US17031804608,"Census Tract 8046,08,Cook County",17|031|804608,Illinois
960,2463,1649,814,1400000US17031804609,"Census Tract 8046,09,Cook County",17|031|804609,Illinois
961,1227,879,348,1400000US17031804610,"Census Tract 8046,10,Cook County",17|031|804610,Illinois
962,1878,1463,415,1400000US17031804611,"Census Tract 8046,11,Cook County",17|031|804611,Illinois
963,2472,1333,1139,1400000US17031804701,"Census Tract 8047,01,Cook County",17|031|804701,Illinois
964,1694,1179,515,1400000US17031804705,"Census Tract 8047,05,Cook County",17|031|804705,Illinois
965,720,688,32,1400000US17031804706,"Census Tract 8047,06,Cook County",17|031|804706,Illinois
966,2906,1406,1500,1400000US17031804709,"Census Tract 8047,09,Cook County",17|031|804709,Illinois
967,1506,1229,277,1400000US17031804710,"Census Tract 8047,10,Cook County",17|031|804710,Illinois
968,2877,1522,1355,1400000US17031804711,"Census Tract 8047,11,Cook County",17|031|804711,Illinois
969,1935,1288,647,1400000US17031804712,"Census Tract 8047,12,Cook County",17|031|804712,Illinois
970,2216,707,1509,1400000US17031804713,"Census Tract 8047,13,Cook County",17|031|804713,Illinois
971,1281,1048,233,1400000US17031804714,"Census Tract 8047,14,Cook County",17|031|804714,Illinois
972,1232,744,488,1400000US17031804715,"Census Tract 8047,15,Cook County",17|031|804715,Illinois
973,1478,1224,254,1400000US17031804716,"Census Tract 8047,16,Cook County",17|031|804716,Illinois
974,1940,1189,751,1400000US17031804803,"Census Tract 8048,03,Cook County",17|031|804803,Illinois
975,2563,1645,918,1400000US17031804804,"Census Tract 8048,04,Cook County",17|031|804804,Illinois
976,2451,2083,368,1400000US17031804805,"Census Tract 8048,05,Cook County",17|031|804805,Illinois
977,999,793,206,1400000US17031804806,"Census Tract 8048,06,Cook County",17|031|804806,Illinois
978,1905,1566,339,1400000US17031804807,"Census Tract 8048,07,Cook County",17|031|804807,Illinois
979,929,899,30,1400000US17031804808,"Census Tract 8048,08,Cook County",17|031|804808,Illinois
980,1651,1513,138,1400000US17031804809,"Census Tract 8048,09,Cook County",17|031|804809,Illinois
981,2865,1958,907,1400000US17031804810,"Census Tract 8048,10,Cook County",17|031|804810,Illinois
982,2375,2142,233,1400000US17031804901,"Census Tract 8049,01,Cook County",17|031|804901,Illinois
983,2179,1969,210,1400000US17031804902,"Census Tract 8049,02,Cook County",17|031|804902,Illinois
984,1913,1806,107,1400000US17031805001,"Census Tract 8050,01,Cook County",17|031|805001,Illinois
985,3005,1321,1684,1400000US17031805002,"Census Tract 8050,02,Cook County",17|031|805002,Illinois
986,2807,1382,1425,1400000US17031805105,"Census Tract 8051,05,Cook County",17|031|805105,Illinois
987,1271,1087,184,1400000US17031805106,"Census Tract 8051,06,Cook County",17|031|805106,Illinois
988,2930,588,2342,1400000US17031805107,"Census Tract 8051,07,Cook County",17|031|805107,Illinois
989,2582,960,1622,1400000US17031805108,"Census Tract 8051,08,Cook County",17|031|805108,Illinois
990,1762,1555,207,1400000US17031805109,"Census Tract 8051,09,Cook County",17|031|805109,Illinois
991,1933,1280,653,1400000US17031805110,"Census Tract 8051,10,Cook County",17|031|805110,Illinois
992,2847,930,1917,1400000US17031805111,"Census Tract 8051,11,Cook County",17|031|805111,Illinois
993,1117,839,278,1400000US17031805112,"Census Tract 8051,12,Cook County",17|031|805112,Illinois
994,1276,1110,166,1400000US17031805201,"Census Tract 8052,01,Cook County",17|031|805201,Illinois
995,1622,1021,601,1400000US17031805202,"Census Tract 8052,02,Cook County",17|031|805202,Illinois
996,1083,894,189,1400000US17031805301,"Census Tract 8053,01,Cook County",17|031|805301,Illinois
997,1429,1321,108,1400000US17031805302,"Census Tract 8053,02,Cook County",17|031|805302,Illinois
998,1627,1317,310,1400000US17031805401,"Census Tract 8054,01,Cook County",17|031|805401,Illinois
999,1771,1667,104,1400000US17031805402,"Census Tract 8054,02,Cook County",17|031|805402,Illinois
1000,1523,1020,503,1400000US17031805501,"Census Tract 8055,01,Cook County",17|031|805501,Illinois
1001,1816,1517,299,1400000US17031805502,"Census Tract 8055,02,Cook County",17|031|805502,Illinois
1002,1655,1632,23,1400000US17031805600,"Census Tract 8056,Cook County",17|031|805600,Illinois
1003,2045,1749,296,1400000US17031805701,"Census Tract 8057,01,Cook County",17|031|805701,Illinois
1004,716,677,39,1400000US17031805702,"Census Tract 8057,02,Cook County",17|031|805702,Illinois
1005,1020,946,74,1400000US17031805801,"Census Tract 8058,01,Cook County",17|031|805801,Illinois
1006,1946,1680,266,1400000US17031805802,"Census Tract 8058,02,Cook County",17|031|805802,Illinois
1007,2045,1464,581,1400000US17031805901,"Census Tract 8059,01,Cook County",17|031|805901,Illinois
1008,2182,1835,347,1400000US17031805902,"Census Tract 8059,02,Cook County",17|031|805902,Illinois
1009,2598,1051,1547,1400000US17031806001,"Census Tract 8060,01,Cook County",17|031|806001,Illinois
1010,2522,1716,806,1400000US17031806002,"Census Tract 8060,02,Cook County",17|031|806002,Illinois
1011,3283,1796,1487,1400000US17031806004,"Census Tract 8060,04,Cook County",17|031|806004,Illinois
1012,1091,664,427,1400000US17031806005,"Census Tract 8060,05,Cook County",17|031|806005,Illinois
1013,1763,1350,413,1400000US17031806006,"Census Tract 8060,06,Cook County",17|031|806006,Illinois
1014,1455,1187,268,1400000US17031806102,"Census Tract 8061,02,Cook County",17|031|806102,Illinois
1015,1970,1763,207,1400000US17031806103,"Census Tract 8061,03,Cook County",17|031|806103,Illinois
1016,1925,629,1296,1400000US17031806104,"Census Tract 8061,04,Cook County",17|031|806104,Illinois
1017,2238,1655,583,1400000US17031806201,"Census Tract 8062,01,Cook County",17|031|806201,Illinois
1018,2527,1646,881,1400000US17031806202,"Census Tract 8062,02,Cook County",17|031|806202,Illinois
1019,1734,1496,238,1400000US17031806300,"Census Tract 8063,Cook County",17|031|806300,Illinois
1020,836,672,164,1400000US17031806400,"Census Tract 8064,Cook County",17|031|806400,Illinois
1021,743,491,252,1400000US17031806501,"Census Tract 8065,01,Cook County",17|031|806501,Illinois
1022,1466,1345,121,1400000US17031806502,"Census Tract 8065,02,Cook County",17|031|806502,Illinois
1023,1206,1126,80,1400000US17031806600,"Census Tract 8066,Cook County",17|031|806600,Illinois
1024,1726,1687,39,1400000US17031806700,"Census Tract 8067,Cook County",17|031|806700,Illinois
1025,1655,1189,466,1400000US17031806801,"Census Tract 8068,01,Cook County",17|031|806801,Illinois
1026,1091,787,304,1400000US17031806802,"Census Tract 8068,02,Cook County",17|031|806802,Illinois
1027,2233,1528,705,1400000US17031806900,"Census Tract 8069,Cook County",17|031|806900,Illinois
1028,2010,942,1068,1400000US17031807000,"Census Tract 8070,Cook County",17|031|807000,Illinois
1029,1163,932,231,1400000US17031807100,"Census Tract 8071,Cook County",17|031|807100,Illinois
1030,1933,1622,311,1400000US17031807200,"Census Tract 8072,Cook County",17|031|807200,Illinois
1031,3012,1734,1278,1400000US17031807300,"Census Tract 8073,Cook County",17|031|807300,Illinois
1032,2374,1454,920,1400000US17031807400,"Census Tract 8074,Cook County",17|031|807400,Illinois
1033,1124,938,186,1400000US17031807500,"Census Tract 8075,Cook County",17|031|807500,Illinois
1034,2154,1886,268,1400000US17031807600,"Census Tract 8076,Cook County",17|031|807600,Illinois
1035,2300,1595,705,1400000US17031807700,"Census Tract 8077,Cook County",17|031|807700,Illinois
1036,859,800,59,1400000US17031807800,"Census Tract 8078,Cook County",17|031|807800,Illinois
1037,1446,1357,89,1400000US17031807900,"Census Tract 8079,Cook County",17|031|807900,Illinois
1038,1467,1306,161,1400000US17031808001,"Census Tract 8080,01,Cook County",17|031|808001,Illinois
1039,1853,1155,698,1400000US17031808002,"Census Tract 8080,02,Cook County",17|031|808002,Illinois
1040,1807,1539,268,1400000US17031808100,"Census Tract 8081,Cook County",17|031|808100,Illinois
1041,1932,1610,322,1400000US17031808200,"Census Tract 8082,Cook County",17|031|808200,Illinois
1042,2742,2129,613,1400000US17031808301,"Census Tract 8083,01,Cook County",17|031|808301,Illinois
1043,1878,1520,358,1400000US17031808302,"Census Tract 8083,02,Cook County",17|031|808302,Illinois
1044,1590,1420,170,1400000US17031808400,"Census Tract 8084,Cook County",17|031|808400,Illinois
1045,1479,1411,68,1400000US17031808500,"Census Tract 8085,Cook County",17|031|808500,Illinois
1046,822,615,207,1400000US17031808600,"Census Tract 8086,Cook County",17|031|808600,Illinois
1047,436,319,117,1400000US17031808702,"Census Tract 8087,02,Cook County",17|031|808702,Illinois
1048,1651,1229,422,1400000US17031808800,"Census Tract 8088,Cook County",17|031|808800,Illinois
1049,1731,1583,148,1400000US17031808900,"Census Tract 8089,Cook County",17|031|808900,Illinois
1050,1520,1221,299,1400000US17031809000,"Census Tract 8090,Cook County",17|031|809000,Illinois
1051,1460,946,514,1400000US17031809100,"Census Tract 8091,Cook County",17|031|809100,Illinois
1052,1562,729,833,1400000US17031809200,"Census Tract 8092,Cook County",17|031|809200,Illinois
1053,1766,502,1264,1400000US17031809300,"Census Tract 8093,Cook County",17|031|809300,Illinois
1054,1436,687,749,1400000US17031809401,"Census Tract 8094,01,Cook County",17|031|809401,Illinois
1055,1358,339,1019,1400000US17031809402,"Census Tract 8094,02,Cook County",17|031|809402,Illinois
1056,1999,673,1326,1400000US17031809500,"Census Tract 8095,Cook County",17|031|809500,Illinois
1057,1321,1057,264,1400000US17031809600,"Census Tract 8096,Cook County",17|031|809600,Illinois
1058,1287,928,359,1400000US17031809700,"Census Tract 8097,Cook County",17|031|809700,Illinois
1059,994,468,526,1400000US17031809800,"Census Tract 8098,Cook County",17|031|809800,Illinois
1060,1287,815,472,1400000US17031809900,"Census Tract 8099,Cook County",17|031|809900,Illinois
1061,2845,1657,1188,1400000US17031810000,"Census Tract 8100,Cook County",17|031|810000,Illinois
1062,1996,961,1035,1400000US17031810100,"Census Tract 8101,Cook County",17|031|810100,Illinois
1063,2753,1119,1634,1400000US17031810200,"Census Tract 8102,Cook County",17|031|810200,Illinois
1064,1573,1021,552,1400000US17031810301,"Census Tract 8103,01,Cook County",17|031|810301,Illinois
1065,1281,816,465,1400000US17031810302,"Census Tract 8103,02,Cook County",17|031|810302,Illinois
1066,2162,2010,152,1400000US17031810400,"Census Tract 8104,Cook County",17|031|810400,Illinois
1067,2058,1846,212,1400000US17031810501,"Census Tract 8105,01,Cook County",17|031|810501,Illinois
1068,2267,1654,613,1400000US17031810502,"Census Tract 8105,02,Cook County",17|031|810502,Illinois
1069,1804,976,828,1400000US17031810600,"Census Tract 8106,Cook County",17|031|810600,Illinois
1070,1830,955,875,1400000US17031810701,"Census Tract 8107,01,Cook County",17|031|810701,Illinois
1071,1439,562,877,1400000US17031810702,"Census Tract 8107,02,Cook County",17|031|810702,Illinois
1072,1662,1365,297,1400000US17031810800,"Census Tract 8108,Cook County",17|031|810800,Illinois
1073,2567,1350,1217,1400000US17031810900,"Census Tract 8109,Cook County",17|031|810900,Illinois
1074,1734,1521,213,1400000US17031811000,"Census Tract 8110,Cook County",17|031|811000,Illinois
1075,2465,1264,1201,1400000US17031811100,"Census Tract 8111,Cook County",17|031|811100,Illinois
1076,1836,1506,330,1400000US17031811200,"Census Tract 8112,Cook County",17|031|811200,Illinois
1077,1395,1092,303,1400000US17031811301,"Census Tract 8113,01,Cook County",17|031|811301,Illinois
1078,1267,455,812,1400000US17031811302,"Census Tract 8113,02,Cook County",17|031|811302,Illinois
1079,1494,1141,353,1400000US17031811401,"Census Tract 8114,01,Cook County",17|031|811401,Illinois
1080,1364,946,418,1400000US17031811402,"Census Tract 8114,02,Cook County",17|031|811402,Illinois
1081,2044,1762,282,1400000US17031811500,"Census Tract 8115,Cook County",17|031|811500,Illinois
1082,2290,1023,1267,1400000US17031811600,"Census Tract 8116,Cook County",17|031|811600,Illinois
1083,1094,532,562,1400000US17031811701,"Census Tract 8117,01,Cook County",17|031|811701,Illinois
1084,1960,1320,640,1400000US17031811702,"Census Tract 8117,02,Cook County",17|031|811702,Illinois
1085,1791,1369,422,1400000US17031811800,"Census Tract 8118,Cook County",17|031|811800,Illinois
1086,1917,1752,165,1400000US17031811900,"Census Tract 8119,Cook County",17|031|811900,Illinois
1087,2511,2204,307,1400000US17031812000,"Census Tract 8120,Cook County",17|031|812000,Illinois
1088,1582,1322,260,1400000US17031812100,"Census Tract 8121,Cook County",17|031|812100,Illinois
1089,1315,1180,135,1400000US17031812200,"Census Tract 8122,Cook County",17|031|812200,Illinois
1090,2968,937,2031,1400000US17031812301,"Census Tract 8123,01,Cook County",17|031|812301,Illinois
1091,1081,890,191,1400000US17031812302,"Census Tract 8123,02,Cook County",17|031|812302,Illinois
1092,1115,1004,111,1400000US17031812400,"Census Tract 8124,Cook County",17|031|812400,Illinois
1093,1594,629,965,1400000US17031812500,"Census Tract 8125,Cook County",17|031|812500,Illinois
1094,1826,760,1066,1400000US17031812600,"Census Tract 8126,Cook County",17|031|812600,Illinois
1095,1604,865,739,1400000US17031812700,"Census Tract 8127,Cook County",17|031|812700,Illinois
1096,1829,724,1105,1400000US17031812801,"Census Tract 8128,01,Cook County",17|031|812801,Illinois
1097,1234,532,702,1400000US17031812802,"Census Tract 8128,02,Cook County",17|031|812802,Illinois
1098,1734,1338,396,1400000US17031812900,"Census Tract 8129,Cook County",17|031|812900,Illinois
1099,1498,1107,391,1400000US17031813000,"Census Tract 8130,Cook County",17|031|813000,Illinois
1100,1801,1198,603,1400000US17031813100,"Census Tract 8131,Cook County",17|031|813100,Illinois
1101,1612,1168,444,1400000US17031813200,"Census Tract 8132,Cook County",17|031|813200,Illinois
1102,982,401,581,1400000US17031813301,"Census Tract 8133,01,Cook County",17|031|813301,Illinois
1103,955,383,572,1400000US17031813302,"Census Tract 8133,02,Cook County",17|031|813302,Illinois
1104,1874,1118,756,1400000US17031813400,"Census Tract 8134,Cook County",17|031|813400,Illinois
1105,1974,1092,882,1400000US17031813500,"Census Tract 8135,Cook County",17|031|813500,Illinois
1106,1630,964,666,1400000US17031813600,"Census Tract 8136,Cook County",17|031|813600,Illinois
1107,986,384,602,1400000US17031813701,"Census Tract 8137,01,Cook County",17|031|813701,Illinois
1108,1244,626,618,1400000US17031813702,"Census Tract 8137,02,Cook County",17|031|813702,Illinois
1109,981,386,595,1400000US17031813801,"Census Tract 8138,01,Cook County",17|031|813801,Illinois
1110,1306,623,683,1400000US17031813802,"Census Tract 8138,02,Cook County",17|031|813802,Illinois
1111,1719,868,851,1400000US17031813900,"Census Tract 8139,Cook County",17|031|813900,Illinois
1112,1388,740,648,1400000US17031814000,"Census Tract 8140,Cook County",17|031|814000,Illinois
1113,1301,563,738,1400000US17031814100,"Census Tract 8141,Cook County",17|031|814100,Illinois
1114,2183,1348,835,1400000US17031814200,"Census Tract 8142,Cook County",17|031|814200,Illinois
1115,1502,883,619,1400000US17031814300,"Census Tract 8143,Cook County",17|031|814300,Illinois
1116,2404,1344,1060,1400000US17031814400,"Census Tract 8144,Cook County",17|031|814400,Illinois
1117,1486,1130,356,1400000US17031814500,"Census Tract 8145,Cook County",17|031|814500,Illinois
1118,1727,1296,431,1400000US17031814600,"Census Tract 8146,Cook County",17|031|814600,Illinois
1119,1558,1146,412,1400000US17031814700,"Census Tract 8147,Cook County",17|031|814700,Illinois
1120,2387,1399,988,1400000US17031814800,"Census Tract 8148,Cook County",17|031|814800,Illinois
1121,2599,693,1906,1400000US17031814900,"Census Tract 8149,Cook County",17|031|814900,Illinois
1122,1295,589,706,1400000US17031815000,"Census Tract 8150,Cook County",17|031|815000,Illinois
1123,1544,915,629,1400000US17031815100,"Census Tract 8151,Cook County",17|031|815100,Illinois
1124,2433,1467,966,1400000US17031815200,"Census Tract 8152,Cook County",17|031|815200,Illinois
1125,1358,1051,307,1400000US17031815300,"Census Tract 8153,Cook County",17|031|815300,Illinois
1126,2332,1049,1283,1400000US17031815400,"Census Tract 8154,Cook County",17|031|815400,Illinois
1127,2292,1802,490,1400000US17031815500,"Census Tract 8155,Cook County",17|031|815500,Illinois
1128,2177,1635,542,1400000US17031815600,"Census Tract 8156,Cook County",17|031|815600,Illinois
1129,1400,1298,102,1400000US17031815701,"Census Tract 8157,01,Cook County",17|031|815701,Illinois
1130,1977,1324,653,1400000US17031815702,"Census Tract 8157,02,Cook County",17|031|815702,Illinois
1131,687,539,148,1400000US17031815800,"Census Tract 8158,Cook County",17|031|815800,Illinois
1132,2755,1145,1610,1400000US17031815900,"Census Tract 8159,Cook County",17|031|815900,Illinois
1133,1658,811,847,1400000US17031816000,"Census Tract 8160,Cook County",17|031|816000,Illinois
1134,2548,1566,982,1400000US17031816100,"Census Tract 8161,Cook County",17|031|816100,Illinois
1135,1681,1151,530,1400000US17031816200,"Census Tract 8162,Cook County",17|031|816200,Illinois
1136,1529,1034,495,1400000US17031816300,"Census Tract 8163,Cook County",17|031|816300,Illinois
1137,1171,345,826,1400000US17031816401,"Census Tract 8164,01,Cook County",17|031|816401,Illinois
1138,1303,722,581,1400000US17031816402,"Census Tract 8164,02,Cook County",17|031|816402,Illinois
1139,1380,938,442,1400000US17031816500,"Census Tract 8165,Cook County",17|031|816500,Illinois
1140,1225,608,617,1400000US17031816600,"Census Tract 8166,Cook County",17|031|816600,Illinois
1141,967,642,325,1400000US17031816700,"Census Tract 8167,Cook County",17|031|816700,Illinois
1142,2029,1782,247,1400000US17031816800,"Census Tract 8168,Cook County",17|031|816800,Illinois
1143,1806,1639,167,1400000US17031816900,"Census Tract 8169,Cook County",17|031|816900,Illinois
1144,1582,1123,459,1400000US17031817000,"Census Tract 8170,Cook County",17|031|817000,Illinois
1145,1622,1059,563,1400000US17031817101,"Census Tract 8171,01,Cook County",17|031|817101,Illinois
1146,1039,689,350,1400000US17031817102,"Census Tract 8171,02,Cook County",17|031|817102,Illinois
1147,1499,645,854,1400000US17031817200,"Census Tract 8172,Cook County",17|031|817200,Illinois
1148,802,450,352,1400000US17031817300,"Census Tract 8173,Cook County",17|031|817300,Illinois
1149,1092,766,326,1400000US17031817400,"Census Tract 8174,Cook County",17|031|817400,Illinois
1150,1369,585,784,1400000US17031817500,"Census Tract 8175,Cook County",17|031|817500,Illinois
1151,1297,817,480,1400000US17031817600,"Census Tract 8176,Cook County",17|031|817600,Illinois
1152,1816,1538,278,1400000US17031817700,"Census Tract 8177,Cook County",17|031|817700,Illinois
1153,2289,1408,881,1400000US17031817900,"Census Tract 8179,Cook County",17|031|817900,Illinois
1154,1841,1141,700,1400000US17031818000,"Census Tract 8180,Cook County",17|031|818000,Illinois
1155,900,846,54,1400000US17031818100,"Census Tract 8181,Cook County",17|031|818100,Illinois
1156,1859,1551,308,1400000US17031818200,"Census Tract 8182,Cook County",17|031|818200,Illinois
1157,1949,1389,560,1400000US17031818300,"Census Tract 8183,Cook County",17|031|818300,Illinois
1158,1382,1158,224,1400000US17031818401,"Census Tract 8184,01,Cook County",17|031|818401,Illinois
1159,1568,1114,454,1400000US17031818402,"Census Tract 8184,02,Cook County",17|031|818402,Illinois
1160,2343,2217,126,1400000US17031818500,"Census Tract 8185,Cook County",17|031|818500,Illinois
1161,1978,1452,526,1400000US17031818600,"Census Tract 8186,Cook County",17|031|818600,Illinois
1162,1518,1401,117,1400000US17031818700,"Census Tract 8187,Cook County",17|031|818700,Illinois
1163,2114,1873,241,1400000US17031818800,"Census Tract 8188,Cook County",17|031|818800,Illinois
1164,1874,1203,671,1400000US17031818900,"Census Tract 8189,Cook County",17|031|818900,Illinois
1165,1501,1277,224,1400000US17031819000,"Census Tract 8190,Cook County",17|031|819000,Illinois
1166,1881,996,885,1400000US17031819100,"Census Tract 8191,Cook County",17|031|819100,Illinois
1167,2125,1629,496,1400000US17031819200,"Census Tract 8192,Cook County",17|031|819200,Illinois
1168,1021,826,195,1400000US17031819300,"Census Tract 8193,Cook County",17|031|819300,Illinois
1169,2250,1458,792,1400000US17031819400,"Census Tract 8194,Cook County",17|031|819400,Illinois
1170,1485,873,612,1400000US17031819500,"Census Tract 8195,Cook County",17|031|819500,Illinois
1171,1342,1226,116,1400000US17031819600,"Census Tract 8196,Cook County",17|031|819600,Illinois
1172,1771,1720,51,1400000US17031819700,"Census Tract 8197,Cook County",17|031|819700,Illinois
1173,1635,1581,54,1400000US17031819801,"Census Tract 8198,01,Cook County",17|031|819801,Illinois
1174,934,902,32,1400000US17031819802,"Census Tract 8198,02,Cook County",17|031|819802,Illinois
1175,1030,1024,6,1400000US17031819900,"Census Tract 8199,Cook County",17|031|819900,Illinois
1176,661,583,78,1400000US17031820000,"Census Tract 8200,Cook County",17|031|820000,Illinois
1177,3350,3108,242,1400000US17031820101,"Census Tract 8201,01,Cook County",17|031|820101,Illinois
1178,1664,1163,501,1400000US17031820103,"Census Tract 8201,03,Cook County",17|031|820103,Illinois
1179,1806,1276,530,1400000US17031820104,"Census Tract 8201,04,Cook County",17|031|820104,Illinois
1180,1348,1028,320,1400000US17031820202,"Census Tract 8202,02,Cook County",17|031|820202,Illinois
1181,1259,1251,8,1400000US17031820203,"Census Tract 8202,03,Cook County",17|031|820203,Illinois
1182,2168,1939,229,1400000US17031820204,"Census Tract 8202,04,Cook County",17|031|820204,Illinois
1183,1614,1039,575,1400000US17031820300,"Census Tract 8203,Cook County",17|031|820300,Illinois
1184,1802,893,909,1400000US17031820400,"Census Tract 8204,Cook County",17|031|820400,Illinois
1185,1983,1451,532,1400000US17031820501,"Census Tract 8205,01,Cook County",17|031|820501,Illinois
1186,2147,1342,805,1400000US17031820502,"Census Tract 8205,02,Cook County",17|031|820502,Illinois
1187,1907,1385,522,1400000US17031820603,"Census Tract 8206,03,Cook County",17|031|820603,Illinois
1188,1266,562,704,1400000US17031820604,"Census Tract 8206,04,Cook County",17|031|820604,Illinois
1189,1913,342,1571,1400000US17031820605,"Census Tract 8206,05,Cook County",17|031|820605,Illinois
1190,1620,1198,422,1400000US17031820606,"Census Tract 8206,06,Cook County",17|031|820606,Illinois
1191,2397,1967,430,1400000US17031820700,"Census Tract 8207,Cook County",17|031|820700,Illinois
1192,1139,953,186,1400000US17031820800,"Census Tract 8208,Cook County",17|031|820800,Illinois
1193,1726,1129,597,1400000US17031820901,"Census Tract 8209,01,Cook County",17|031|820901,Illinois
1194,1726,1493,233,1400000US17031820902,"Census Tract 8209,02,Cook County",17|031|820902,Illinois
1195,1672,1108,564,1400000US17031821001,"Census Tract 8210,01,Cook County",17|031|821001,Illinois
1196,1814,1566,248,1400000US17031821002,"Census Tract 8210,02,Cook County",17|031|821002,Illinois
1197,1415,1167,248,1400000US17031821101,"Census Tract 8211,01,Cook County",17|031|821101,Illinois
1198,1550,1317,233,1400000US17031821102,"Census Tract 8211,02,Cook County",17|031|821102,Illinois
1199,2185,1046,1139,1400000US17031821200,"Census Tract 8212,Cook County",17|031|821200,Illinois
1200,2211,808,1403,1400000US17031821300,"Census Tract 8213,Cook County",17|031|821300,Illinois
1201,1144,677,467,1400000US17031821401,"Census Tract 8214,01,Cook County",17|031|821401,Illinois
1202,1253,748,505,1400000US17031821402,"Census Tract 8214,02,Cook County",17|031|821402,Illinois
1203,608,206,402,1400000US17031821500,"Census Tract 8215,Cook County",17|031|821500,Illinois
1204,1841,1467,374,1400000US17031821600,"Census Tract 8216,Cook County",17|031|821600,Illinois
1205,1785,1414,371,1400000US17031821700,"Census Tract 8217,Cook County",17|031|821700,Illinois
1206,2085,1712,373,1400000US17031821800,"Census Tract 8218,Cook County",17|031|821800,Illinois
1207,1784,1647,137,1400000US17031821900,"Census Tract 8219,Cook County",17|031|821900,Illinois
1208,1895,1369,526,1400000US17031822000,"Census Tract 8220,Cook County",17|031|822000,Illinois
1209,1577,1267,310,1400000US17031822101,"Census Tract 8221,01,Cook County",17|031|822101,Illinois
1210,1962,1473,489,1400000US17031822102,"Census Tract 8221,02,Cook County",17|031|822102,Illinois
1211,1307,1173,134,1400000US17031822200,"Census Tract 8222,Cook County",17|031|822200,Illinois
1212,1165,1082,83,1400000US17031822301,"Census Tract 8223,01,Cook County",17|031|822301,Illinois
1213,1679,1320,359,1400000US17031822302,"Census Tract 8223,02,Cook County",17|031|822302,Illinois
1214,2115,1508,607,1400000US17031822400,"Census Tract 8224,Cook County",17|031|822400,Illinois
1215,1698,1471,227,1400000US17031822500,"Census Tract 8225,Cook County",17|031|822500,Illinois
1216,1603,1506,97,1400000US17031822601,"Census Tract 8226,01,Cook County",17|031|822601,Illinois
1217,3168,2371,797,1400000US17031822602,"Census Tract 8226,02,Cook County",17|031|822602,Illinois
1218,1974,1570,404,1400000US17031822701,"Census Tract 8227,01,Cook County",17|031|822701,Illinois
1219,1446,1084,362,1400000US17031822702,"Census Tract 8227,02,Cook County",17|031|822702,Illinois
1220,1476,1127,349,1400000US17031822801,"Census Tract 8228,01,Cook County",17|031|822801,Illinois
1221,1281,1196,85,1400000US17031822802,"Census Tract 8228,02,Cook County",17|031|822802,Illinois
1222,819,648,171,1400000US17031822900,"Census Tract 8229,Cook County",17|031|822900,Illinois
1223,2728,1505,1223,1400000US17031823001,"Census Tract 8230,01,Cook County",17|031|823001,Illinois
1224,2032,1210,822,1400000US17031823002,"Census Tract 8230,02,Cook County",17|031|823002,Illinois
1225,1708,998,710,1400000US17031823101,"Census Tract 8231,01,Cook County",17|031|823101,Illinois
1226,1509,908,601,1400000US17031823102,"Census Tract 8231,02,Cook County",17|031|823102,Illinois
1227,1845,1624,221,1400000US17031823200,"Census Tract 8232,Cook County",17|031|823200,Illinois
1228,2470,1311,1159,1400000US17031823302,"Census Tract 8233,02,Cook County",17|031|823302,Illinois
1229,1617,1107,510,1400000US17031823303,"Census Tract 8233,03,Cook County",17|031|823303,Illinois
1230,2634,1456,1178,1400000US17031823304,"Census Tract 8233,04,Cook County",17|031|823304,Illinois
1231,1888,1247,641,1400000US17031823400,"Census Tract 8234,Cook County",17|031|823400,Illinois
1232,1499,892,607,1400000US17031823500,"Census Tract 8235,Cook County",17|031|823500,Illinois
1233,2803,2214,589,1400000US17031823602,"Census Tract 8236,02,Cook County",17|031|823602,Illinois
1234,545,343,202,1400000US17031823603,"Census Tract 8236,03,Cook County",17|031|823603,Illinois
1235,1160,1140,20,1400000US17031823604,"Census Tract 8236,04,Cook County",17|031|823604,Illinois
1236,1380,1230,150,1400000US17031823605,"Census Tract 8236,05,Cook County",17|031|823605,Illinois
1237,2691,1423,1268,1400000US17031823702,"Census Tract 8237,02,Cook County",17|031|823702,Illinois
1238,2928,1995,933,1400000US17031823703,"Census Tract 8237,03,Cook County",17|031|823703,Illinois
1239,1365,1294,71,1400000US17031823704,"Census Tract 8237,04,Cook County",17|031|823704,Illinois
1240,1624,1168,456,1400000US17031823705,"Census Tract 8237,05,Cook County",17|031|823705,Illinois
1241,2065,1827,238,1400000US17031823801,"Census Tract 8238,01,Cook County",17|031|823801,Illinois
1242,2739,2488,251,1400000US17031823803,"Census Tract 8238,03,Cook County",17|031|823803,Illinois
1243,1582,1469,113,1400000US17031823805,"Census Tract 8238,05,Cook County",17|031|823805,Illinois
1244,1761,1119,642,1400000US17031823806,"Census Tract 8238,06,Cook County",17|031|823806,Illinois
1245,1629,1563,66,1400000US17031823901,"Census Tract 8239,01,Cook County",17|031|823901,Illinois
1246,1713,1635,78,1400000US17031823903,"Census Tract 8239,03,Cook County",17|031|823903,Illinois
1247,1591,1448,143,1400000US17031823904,"Census Tract 8239,04,Cook County",17|031|823904,Illinois
1248,2011,1837,174,1400000US17031824003,"Census Tract 8240,03,Cook County",17|031|824003,Illinois
1249,1932,1366,566,1400000US17031824004,"Census Tract 8240,04,Cook County",17|031|824004,Illinois
1250,1976,1780,196,1400000US17031824005,"Census Tract 8240,05,Cook County",17|031|824005,Illinois
1251,1834,1778,56,1400000US17031824006,"Census Tract 8240,06,Cook County",17|031|824006,Illinois
1252,2723,2412,311,1400000US17031824105,"Census Tract 8241,05,Cook County",17|031|824105,Illinois
1253,2425,2166,259,1400000US17031824106,"Census Tract 8241,06,Cook County",17|031|824106,Illinois
1254,2802,2401,401,1400000US17031824107,"Census Tract 8241,07,Cook County",17|031|824107,Illinois
1255,2337,2200,137,1400000US17031824113,"Census Tract 8241,13,Cook County",17|031|824113,Illinois
1256,1854,1732,122,1400000US17031824114,"Census Tract 8241,14,Cook County",17|031|824114,Illinois
1257,1534,1362,172,1400000US17031824115,"Census Tract 8241,15,Cook County",17|031|824115,Illinois
1258,2317,1137,1180,1400000US17031824116,"Census Tract 8241,16,Cook County",17|031|824116,Illinois
1259,2230,2091,139,1400000US17031824119,"Census Tract 8241,19,Cook County",17|031|824119,Illinois
1260,1302,1242,60,1400000US17031824121,"Census Tract 8241,21,Cook County",17|031|824121,Illinois
1261,2365,2317,48,1400000US17031824122,"Census Tract 8241,22,Cook County",17|031|824122,Illinois
1262,2771,2418,353,1400000US17031824123,"Census Tract 8241,23,Cook County",17|031|824123,Illinois
1263,1109,750,359,1400000US17031824124,"Census Tract 8241,24,Cook County",17|031|824124,Illinois
1264,1430,1331,99,1400000US17031824125,"Census Tract 8241,25,Cook County",17|031|824125,Illinois
1265,2065,2044,21,1400000US17031824126,"Census Tract 8241,26,Cook County",17|031|824126,Illinois
1266,1440,1426,14,1400000US17031824127,"Census Tract 8241,27,Cook County",17|031|824127,Illinois
1267,1683,1586,97,1400000US17031824128,"Census Tract 8241,28,Cook County",17|031|824128,Illinois
1268,1627,1514,113,1400000US17031824129,"Census Tract 8241,29,Cook County",17|031|824129,Illinois
1269,1493,890,603,1400000US17031824300,"Census Tract 8243,Cook County",17|031|824300,Illinois
1270,691,411,280,1400000US17031824400,"Census Tract 8244,Cook County",17|031|824400,Illinois
1271,2538,2123,415,1400000US17031824503,"Census Tract 8245,03,Cook County",17|031|824503,Illinois
1272,2544,1906,638,1400000US17031824505,"Census Tract 8245,05,Cook County",17|031|824505,Illinois
1273,1758,1339,419,1400000US17031824507,"Census Tract 8245,07,Cook County",17|031|824507,Illinois
1274,1615,1242,373,1400000US17031824508,"Census Tract 8245,08,Cook County",17|031|824508,Illinois
1275,1619,1479,140,1400000US17031824509,"Census Tract 8245,09,Cook County",17|031|824509,Illinois
1276,1588,1435,153,1400000US17031824601,"Census Tract 8246,01,Cook County",17|031|824601,Illinois
1277,2494,1911,583,1400000US17031824602,"Census Tract 8246,02,Cook County",17|031|824602,Illinois
1278,1476,968,508,1400000US17031824701,"Census Tract 8247,01,Cook County",17|031|824701,Illinois
1279,2209,1803,406,1400000US17031824702,"Census Tract 8247,02,Cook County",17|031|824702,Illinois
1280,2258,1636,622,1400000US17031824800,"Census Tract 8248,Cook County",17|031|824800,Illinois
1281,1068,832,236,1400000US17031824900,"Census Tract 8249,Cook County",17|031|824900,Illinois
1282,1899,1146,753,1400000US17031825000,"Census Tract 8250,Cook County",17|031|825000,Illinois
1283,752,693,59,1400000US17031825200,"Census Tract 8252,Cook County",17|031|825200,Illinois
1284,2232,1616,616,1400000US17031825302,"Census Tract 8253,02,Cook County",17|031|825302,Illinois
1285,1608,879,729,1400000US17031825303,"Census Tract 8253,03,Cook County",17|031|825303,Illinois
1286,1663,1329,334,1400000US17031825304,"Census Tract 8253,04,Cook County",17|031|825304,Illinois
1287,2478,2043,435,1400000US17031825400,"Census Tract 8254,Cook County",17|031|825400,Illinois
1288,1829,1015,814,1400000US17031825501,"Census Tract 8255,01,Cook County",17|031|825501,Illinois
1289,2490,2089,401,1400000US17031825503,"Census Tract 8255,03,Cook County",17|031|825503,Illinois
1290,1301,791,510,1400000US17031825504,"Census Tract 8255,04,Cook County",17|031|825504,Illinois
1291,1737,1320,417,1400000US17031825505,"Census Tract 8255,05,Cook County",17|031|825505,Illinois
1292,1545,980,565,1400000US17031825600,"Census Tract 8256,Cook County",17|031|825600,Illinois
1293,1594,992,602,1400000US17031825700,"Census Tract 8257,Cook County",17|031|825700,Illinois
1294,1483,581,902,1400000US17031825801,"Census Tract 8258,01,Cook County",17|031|825801,Illinois
1295,2215,1532,683,1400000US17031825802,"Census Tract 8258,02,Cook County",17|031|825802,Illinois
1296,2329,1278,1051,1400000US17031825803,"Census Tract 8258,03,Cook County",17|031|825803,Illinois
1297,1112,710,402,1400000US17031825900,"Census Tract 8259,Cook County",17|031|825900,Illinois
1298,931,636,295,1400000US17031826000,"Census Tract 8260,Cook County",17|031|826000,Illinois
1299,2020,1089,931,1400000US17031826100,"Census Tract 8261,Cook County",17|031|826100,Illinois
1300,2119,1111,1008,1400000US17031826201,"Census Tract 8262,01,Cook County",17|031|826201,Illinois
1301,1913,1419,494,1400000US17031826202,"Census Tract 8262,02,Cook County",17|031|826202,Illinois
1302,1520,1094,426,1400000US17031826301,"Census Tract 8263,01,Cook County",17|031|826301,Illinois
1303,1182,973,209,1400000US17031826303,"Census Tract 8263,03,Cook County",17|031|826303,Illinois
1304,1260,729,531,1400000US17031826304,"Census Tract 8263,04,Cook County",17|031|826304,Illinois
1305,1306,938,368,1400000US17031826401,"Census Tract 8264,01,Cook County",17|031|826401,Illinois
1306,1707,1150,557,1400000US17031826402,"Census Tract 8264,02,Cook County",17|031|826402,Illinois
1307,2045,1443,602,1400000US17031826500,"Census Tract 8265,Cook County",17|031|826500,Illinois
1308,1612,899,713,1400000US17031826600,"Census Tract 8266,Cook County",17|031|826600,Illinois
1309,1731,689,1042,1400000US17031826700,"Census Tract 8267,Cook County",17|031|826700,Illinois
1310,1549,803,746,1400000US17031826800,"Census Tract 8268,Cook County",17|031|826800,Illinois
1311,681,255,426,1400000US17031826901,"Census Tract 8269,01,Cook County",17|031|826901,Illinois
1312,406,175,231,1400000US17031826902,"Census Tract 8269,02,Cook County",17|031|826902,Illinois
1313,1255,645,610,1400000US17031827000,"Census Tract 8270,Cook County",17|031|827000,Illinois
1314,886,317,569,1400000US17031827100,"Census Tract 8271,Cook County",17|031|827100,Illinois
1315,1342,947,395,1400000US17031827200,"Census Tract 8272,Cook County",17|031|827200,Illinois
1316,844,344,500,1400000US17031827300,"Census Tract 8273,Cook County",17|031|827300,Illinois
1317,1161,569,592,1400000US17031827400,"Census Tract 8274,Cook County",17|031|827400,Illinois
1318,1388,816,572,1400000US17031827500,"Census Tract 8275,Cook County",17|031|827500,Illinois
1319,891,553,338,1400000US17031827600,"Census Tract 8276,Cook County",17|031|827600,Illinois
1320,875,363,512,1400000US17031827700,"Census Tract 8277,Cook County",17|031|827700,Illinois
1321,1652,1266,386,1400000US17031827801,"Census Tract 8278,01,Cook County",17|031|827801,Illinois
1322,933,795,138,1400000US17031827802,"Census Tract 8278,02,Cook County",17|031|827802,Illinois
1323,1285,1121,164,1400000US17031827804,"Census Tract 8278,04,Cook County",17|031|827804,Illinois
1324,994,869,125,1400000US17031827805,"Census Tract 8278,05,Cook County",17|031|827805,Illinois
1325,735,708,27,1400000US17031827901,"Census Tract 8279,01,Cook County",17|031|827901,Illinois
1326,1577,1018,559,1400000US17031827902,"Census Tract 8279,02,Cook County",17|031|827902,Illinois
1327,2101,1342,759,1400000US17031828000,"Census Tract 8280,Cook County",17|031|828000,Illinois
1328,2037,1610,427,1400000US17031828100,"Census Tract 8281,Cook County",17|031|828100,Illinois
1329,1532,1137,395,1400000US17031828201,"Census Tract 8282,01,Cook County",17|031|828201,Illinois
1330,1925,1128,797,1400000US17031828202,"Census Tract 8282,02,Cook County",17|031|828202,Illinois
1331,1419,1196,223,1400000US17031828300,"Census Tract 8283,Cook County",17|031|828300,Illinois
1332,1397,947,450,1400000US17031828401,"Census Tract 8284,01,Cook County",17|031|828401,Illinois
1333,1555,1040,515,1400000US17031828402,"Census Tract 8284,02,Cook County",17|031|828402,Illinois
1334,1531,839,692,1400000US17031828503,"Census Tract 8285,03,Cook County",17|031|828503,Illinois
1335,1670,953,717,1400000US17031828504,"Census Tract 8285,04,Cook County",17|031|828504,Illinois
1336,2662,2156,506,1400000US17031828505,"Census Tract 8285,05,Cook County",17|031|828505,Illinois
1337,1227,1120,107,1400000US17031828507,"Census Tract 8285,07,Cook County",17|031|828507,Illinois
1338,1522,1008,514,1400000US17031828508,"Census Tract 8285,08,Cook County",17|031|828508,Illinois
1339,1720,1468,252,1400000US17031828601,"Census Tract 8286,01,Cook County",17|031|828601,Illinois
1340,1447,1213,234,1400000US17031828602,"Census Tract 8286,02,Cook County",17|031|828602,Illinois
1341,1408,1039,369,1400000US17031828701,"Census Tract 8287,01,Cook County",17|031|828701,Illinois
1342,1595,1190,405,1400000US17031828702,"Census Tract 8287,02,Cook County",17|031|828702,Illinois
1343,1762,1563,199,1400000US17031828801,"Census Tract 8288,01,Cook County",17|031|828801,Illinois
1344,1074,937,137,1400000US17031828802,"Census Tract 8288,02,Cook County",17|031|828802,Illinois
1345,1166,549,617,1400000US17031828900,"Census Tract 8289,Cook County",17|031|828900,Illinois
1346,314,113,201,1400000US17031829000,"Census Tract 8290,Cook County",17|031|829000,Illinois
1347,1204,580,624,1400000US17031829100,"Census Tract 8291,Cook County",17|031|829100,Illinois
1348,1886,1259,627,1400000US17031829200,"Census Tract 8292,Cook County",17|031|829200,Illinois
1349,1407,1297,110,1400000US17031829301,"Census Tract 8293,01,Cook County",17|031|829301,Illinois
1350,1103,506,597,1400000US17031829302,"Census Tract 8293,02,Cook County",17|031|829302,Illinois
1351,330,234,96,1400000US17031829401,"Census Tract 8294,01,Cook County",17|031|829401,Illinois
1352,1249,756,493,1400000US17031829402,"Census Tract 8294,02,Cook County",17|031|829402,Illinois
1353,1556,1026,530,1400000US17031829500,"Census Tract 8295,Cook County",17|031|829500,Illinois
1354,1152,931,221,1400000US17031829600,"Census Tract 8296,Cook County",17|031|829600,Illinois
1355,1015,656,359,1400000US17031829700,"Census Tract 8297,Cook County",17|031|829700,Illinois
1356,2234,2006,228,1400000US17031829800,"Census Tract 8298,Cook County",17|031|829800,Illinois
1357,2536,2258,278,1400000US17031829902,"Census Tract 8299,02,Cook County",17|031|829902,Illinois
1358,1600,1246,354,1400000US17031829903,"Census Tract 8299,03,Cook County",17|031|829903,Illinois
1359,1965,1847,118,1400000US17031829904,"Census Tract 8299,04,Cook County",17|031|829904,Illinois
1360,1137,895,242,1400000US17031830001,"Census Tract 8300,01,Cook County",17|031|830001,Illinois
1361,2822,2390,432,1400000US17031830003,"Census Tract 8300,03,Cook County",17|031|830003,Illinois
1362,2502,1959,543,1400000US17031830004,"Census Tract 8300,04,Cook County",17|031|830004,Illinois
1363,1622,1361,261,1400000US17031830005,"Census Tract 8300,05,Cook County",17|031|830005,Illinois
1364,1252,679,573,1400000US17031830006,"Census Tract 8300,06,Cook County",17|031|830006,Illinois
1365,1882,810,1072,1400000US17031830007,"Census Tract 8300,07,Cook County",17|031|830007,Illinois
1366,1440,1271,169,1400000US17031830008,"Census Tract 8300,08,Cook County",17|031|830008,Illinois
1367,971,790,181,1400000US17031830100,"Census Tract 8301,Cook County",17|031|830100,Illinois
1368,2086,827,1259,1400000US17031830201,"Census Tract 8302,01,Cook County",17|031|830201,Illinois
1369,1100,823,277,1400000US17031830202,"Census Tract 8302,02,Cook County",17|031|830202,Illinois
1370,2248,856,1392,1400000US17031830300,"Census Tract 8303,Cook County",17|031|830300,Illinois
1371,1589,1062,527,1400000US17031830400,"Census Tract 8304,Cook County",17|031|830400,Illinois
1372,1137,816,321,1400000US17031830500,"Census Tract 8305,Cook County",17|031|830500,Illinois
1373,2127,458,1669,1400000US17031830600,"Census Tract 8306,Cook County",17|031|830600,Illinois
1374,1919,498,1421,1400000US17031830700,"Census Tract 8307,Cook County",17|031|830700,Illinois
1375,1505,261,1244,1400000US17031830800,"Census Tract 8308,Cook County",17|031|830800,Illinois
1376,1305,581,724,1400000US17031830900,"Census Tract 8309,Cook County",17|031|830900,Illinois
1377,1037,670,367,1400000US17031831000,"Census Tract 8310,Cook County",17|031|831000,Illinois
1378,2671,1246,1425,1400000US17031831100,"Census Tract 8311,Cook County",17|031|831100,Illinois
1379,1560,621,939,1400000US17031831200,"Census Tract 8312,Cook County",17|031|831200,Illinois
1380,381,144,237,1400000US17031831300,"Census Tract 8313,Cook County",17|031|831300,Illinois
1381,1031,448,583,1400000US17031831400,"Census Tract 8314,Cook County",17|031|831400,Illinois
1382,1360,796,564,1400000US17031831500,"Census Tract 8315,Cook County",17|031|831500,Illinois
1383,2519,1315,1204,1400000US17031831600,"Census Tract 8316,Cook County",17|031|831600,Illinois
1384,917,415,502,1400000US17031831700,"Census Tract 8317,Cook County",17|031|831700,Illinois
1385,2506,1166,1340,1400000US17031831800,"Census Tract 8318,Cook County",17|031|831800,Illinois
1386,1507,619,888,1400000US17031831900,"Census Tract 8319,Cook County",17|031|831900,Illinois
1387,977,419,558,1400000US17031832000,"Census Tract 8320,Cook County",17|031|832000,Illinois
1388,1818,477,1341,1400000US17031832100,"Census Tract 8321,Cook County",17|031|832100,Illinois
1389,1487,513,974,1400000US17031832200,"Census Tract 8322,Cook County",17|031|832200,Illinois
1390,981,402,579,1400000US17031832300,"Census Tract 8323,Cook County",17|031|832300,Illinois
1391,1498,746,752,1400000US17031832400,"Census Tract 8324,Cook County",17|031|832400,Illinois
1392,1396,699,697,1400000US17031832500,"Census Tract 8325,Cook County",17|031|832500,Illinois
1393,1728,1027,701,1400000US17031832600,"Census Tract 8326,Cook County",17|031|832600,Illinois
1394,691,240,451,1400000US17031832900,"Census Tract 8329,Cook County",17|031|832900,Illinois
1395,2731,890,1841,1400000US17031833000,"Census Tract 8330,Cook County",17|031|833000,Illinois
1396,4373,2748,1625,1400000US17031833100,"Census Tract 8331,Cook County",17|031|833100,Illinois
1397,1157,404,753,1400000US17031833300,"Census Tract 8333,Cook County",17|031|833300,Illinois
1398,823,233,590,1400000US17031833900,"Census Tract 8339,Cook County",17|031|833900,Illinois
1399,1124,140,984,1400000US17031834000,"Census Tract 8340,Cook County",17|031|834000,Illinois
1400,1980,781,1199,1400000US17031834200,"Census Tract 8342,Cook County",17|031|834200,Illinois
1401,2633,1794,839,1400000US17031834300,"Census Tract 8343,Cook County",17|031|834300,Illinois
1402,1896,552,1344,1400000US17031834400,"Census Tract 8344,Cook County",17|031|834400,Illinois
1403,482,28,454,1400000US17031834500,"Census Tract 8345,Cook County",17|031|834500,Illinois
1404,778,165,613,1400000US17031834600,"Census Tract 8346,Cook County",17|031|834600,Illinois
1405,566,147,419,1400000US17031834700,"Census Tract 8347,Cook County",17|031|834700,Illinois
1406,752,144,608,1400000US17031834800,"Census Tract 8348,Cook County",17|031|834800,Illinois
1407,586,91,495,1400000US17031834900,"Census Tract 8349,Cook County",17|031|834900,Illinois
1408,1952,609,1343,1400000US17031835000,"Census Tract 8350,Cook County",17|031|835000,Illinois
1409,1331,778,553,1400000US17031835100,"Census Tract 8351,Cook County",17|031|835100,Illinois
1410,657,459,198,1400000US17031835200,"Census Tract 8352,Cook County",17|031|835200,Illinois
1411,679,134,545,1400000US17031835500,"Census Tract 8355,Cook County",17|031|835500,Illinois
1412,451,65,386,1400000US17031835600,"Census Tract 8356,Cook County",17|031|835600,Illinois
1413,733,356,377,1400000US17031835800,"Census Tract 8358,Cook County",17|031|835800,Illinois
1414,1068,525,543,1400000US17031836000,"Census Tract 8360,Cook County",17|031|836000,Illinois
1415,759,157,602,1400000US17031836100,"Census Tract 8361,Cook County",17|031|836100,Illinois
1416,98,70,28,1400000US17031836200,"Census Tract 8362,Cook County",17|031|836200,Illinois
1417,674,216,458,1400000US17031836300,"Census Tract 8363,Cook County",17|031|836300,Illinois
1418,1865,691,1174,1400000US17031836400,"Census Tract 8364,Cook County",17|031|836400,Illinois
1419,774,131,643,1400000US17031836500,"Census Tract 8365,Cook County",17|031|836500,Illinois
1420,928,290,638,1400000US17031836600,"Census Tract 8366,Cook County",17|031|836600,Illinois
1421,1057,298,759,1400000US17031836700,"Census Tract 8367,Cook County",17|031|836700,Illinois
1422,906,127,779,1400000US17031836800,"Census Tract 8368,Cook County",17|031|836800,Illinois
1423,585,123,462,1400000US17031836900,"Census Tract 8369,Cook County",17|031|836900,Illinois
1424,778,213,565,1400000US17031837000,"Census Tract 8370,Cook County",17|031|837000,Illinois
1425,713,236,477,1400000US17031837100,"Census Tract 8371,Cook County",17|031|837100,Illinois
1426,927,227,700,1400000US17031837300,"Census Tract 8373,Cook County",17|031|837300,Illinois
1427,703,228,475,1400000US17031837400,"Census Tract 8374,Cook County",17|031|837400,Illinois
1428,1108,205,903,1400000US17031837800,"Census Tract 8378,Cook County",17|031|837800,Illinois
1429,1396,424,972,1400000US17031838000,"Census Tract 8380,Cook County",17|031|838000,Illinois
1430,1021,188,833,1400000US17031838100,"Census Tract 8381,Cook County",17|031|838100,Illinois
1431,371,234,137,1400000US17031838200,"Census Tract 8382,Cook County",17|031|838200,Illinois
1432,1103,175,928,1400000US17031838300,"Census Tract 8383,Cook County",17|031|838300,Illinois
1433,631,34,597,1400000US17031838600,"Census Tract 8386,Cook County",17|031|838600,Illinois
1434,1516,381,1135,1400000US17031838700,"Census Tract 8387,Cook County",17|031|838700,Illinois
1435,1136,384,752,1400000US17031838800,"Census Tract 8388,Cook County",17|031|838800,Illinois
1436,5768,1552,4216,1400000US17031839000,"Census Tract 8390,Cook County",17|031|839000,Illinois
1437,4652,1429,3223,1400000US17031839100,"Census Tract 8391,Cook County",17|031|839100,Illinois
1438,1429,641,788,1400000US17031839200,"Census Tract 8392,Cook County",17|031|839200,Illinois
1439,748,354,394,1400000US17031839500,"Census Tract 8395,Cook County",17|031|839500,Illinois
1440,926,393,533,1400000US17031839600,"Census Tract 8396,Cook County",17|031|839600,Illinois
1441,1848,1027,821,1400000US17031839700,"Census Tract 8397,Cook County",17|031|839700,Illinois
1442,1085,315,770,1400000US17031839800,"Census Tract 8398,Cook County",17|031|839800,Illinois
1443,2110,1182,928,1400000US17031839900,"Census Tract 8399,Cook County",17|031|839900,Illinois
1444,1064,634,430,1400000US17031840000,"Census Tract 8400,Cook County",17|031|840000,Illinois
1445,1140,578,562,1400000US17031840100,"Census Tract 8401,Cook County",17|031|840100,Illinois
1446,822,487,335,1400000US17031840200,"Census Tract 8402,Cook County",17|031|840200,Illinois
1447,1221,901,320,1400000US17031840300,"Census Tract 8403,Cook County",17|031|840300,Illinois
1448,1140,911,229,1400000US17031840400,"Census Tract 8404,Cook County",17|031|840400,Illinois
1449,1153,576,577,1400000US17031840700,"Census Tract 8407,Cook County",17|031|840700,Illinois
1450,885,404,481,1400000US17031840800,"Census Tract 8408,Cook County",17|031|840800,Illinois
1451,634,337,297,1400000US17031841000,"Census Tract 8410,Cook County",17|031|841000,Illinois
1452,2810,1234,1576,1400000US17031841100,"Census Tract 8411,Cook County",17|031|841100,Illinois
1453,1648,336,1312,1400000US17031841200,"Census Tract 8412,Cook County",17|031|841200,Illinois
1454,1843,862,981,1400000US17031841300,"Census Tract 8413,Cook County",17|031|841300,Illinois
1455,807,212,595,1400000US17031841500,"Census Tract 8415,Cook County",17|031|841500,Illinois
1456,601,150,451,1400000US17031841700,"Census Tract 8417,Cook County",17|031|841700,Illinois
1457,904,424,480,1400000US17031841800,"Census Tract 8418,Cook County",17|031|841800,Illinois
1458,1549,1067,482,1400000US17031841900,"Census Tract 8419,Cook County",17|031|841900,Illinois
1459,358,251,107,1400000US17031842000,"Census Tract 8420,Cook County",17|031|842000,Illinois
1460,2079,1128,951,1400000US17031842100,"Census Tract 8421,Cook County",17|031|842100,Illinois
1461,2287,839,1448,1400000US17031842200,"Census Tract 8422,Cook County",17|031|842200,Illinois
1462,1591,902,689,1400000US17031842300,"Census Tract 8423,Cook County",17|031|842300,Illinois
1463,1433,892,541,1400000US17031842400,"Census Tract 8424,Cook County",17|031|842400,Illinois
1464,897,61,836,1400000US17031842500,"Census Tract 8425,Cook County",17|031|842500,Illinois
1465,1517,844,673,1400000US17031842600,"Census Tract 8426,Cook County",17|031|842600,Illinois
1466,1922,802,1120,1400000US17031842800,"Census Tract 8428,Cook County",17|031|842800,Illinois
1467,1434,402,1032,1400000US17031842900,"Census Tract 8429,Cook County",17|031|842900,Illinois
1468,1036,210,826,1400000US17031843000,"Census Tract 8430,Cook County",17|031|843000,Illinois
1469,426,94,332,1400000US17031843100,"Census Tract 8431,Cook County",17|031|843100,Illinois
1470,960,300,660,1400000US17031843200,"Census Tract 8432,Cook County",17|031|843200,Illinois
1471,375,28,347,1400000US17031843300,"Census Tract 8433,Cook County",17|031|843300,Illinois
1472,459,193,266,1400000US17031843400,"Census Tract 8434,Cook County",17|031|843400,Illinois
1473,232,108,124,1400000US17031843500,"Census Tract 8435,Cook County",17|031|843500,Illinois
1474,1503,338,1165,1400000US17031843600,"Census Tract 8436,Cook County",17|031|843600,Illinois
1475,1040,676,364,1400000US17031843700,"Census Tract 8437,Cook County",17|031|843700,Illinois
1476,704,260,444,1400000US17031843800,"Census Tract 8438,Cook County",17|031|843800,Illinois
1477,2073,971,1102,1400000US17031843900,"Census Tract 8439,Cook County",17|031|843900,Illinois
1478,809,137,672,1400000US17031844600,"Census Tract 8446,Cook County",17|031|844600,Illinois
1479,653,193,460,1400000US17031844700,"Census Tract 8447,Cook County",17|031|844700,Illinois
1480,0,0,0,1400000US17031980000,"Census Tract 9800,Cook County",17|031|980000,Illinois
1481,0,0,0,1400000US17031980100,"Census Tract 9801,Cook County",17|031|980100,Illinois
1482,0,0,0,1400000US17031990000,"Census Tract 9900,Cook County",17|031|990000,Illinois
1483,1137,989,148,1400000US17033880100,"Census Tract 8801,Crawford County",17|033|880100,Illinois
1484,1490,1142,348,1400000US17033880200,"Census Tract 8802,Crawford County",17|033|880200,Illinois
1485,1442,1111,331,1400000US17033880300,"Census Tract 8803,Crawford County",17|033|880300,Illinois
1486,1172,634,538,1400000US17033880400,"Census Tract 8804,Crawford County",17|033|880400,Illinois
1487,1023,859,164,1400000US17033880500,"Census Tract 8805,Crawford County",17|033|880500,Illinois
1488,1248,1119,129,1400000US17033880600,"Census Tract 8806,Crawford County",17|033|880600,Illinois
1489,1273,1071,202,1400000US17035972400,"Census Tract 9724,Cumberland County",17|035|972400,Illinois
1490,1267,967,300,1400000US17035972500,"Census Tract 9725,Cumberland County",17|035|972500,Illinois
1491,1586,1292,294,1400000US17035972600,"Census Tract 9726,Cumberland County",17|035|972600,Illinois
1492,2516,1682,834,1400000US17037000100,"Census Tract 1,DeKalb County",17|037|000100,Illinois
1493,1838,1379,459,1400000US17037000200,"Census Tract 2,DeKalb County",17|037|000200,Illinois
1494,1014,732,282,1400000US17037000300,"Census Tract 3,DeKalb County",17|037|000300,Illinois
1495,1699,1184,515,1400000US17037000401,"Census Tract 4,01,DeKalb County",17|037|000401,Illinois
1496,1397,1175,222,1400000US17037000402,"Census Tract 4,02,DeKalb County",17|037|000402,Illinois
1497,1727,1102,625,1400000US17037000500,"Census Tract 5,DeKalb County",17|037|000500,Illinois
1498,2255,1271,984,1400000US17037000600,"Census Tract 6,DeKalb County",17|037|000600,Illinois
1499,1669,1238,431,1400000US17037000700,"Census Tract 7,DeKalb County",17|037|000700,Illinois
1500,2562,1331,1231,1400000US17037000800,"Census Tract 8,DeKalb County",17|037|000800,Illinois
1501,2153,1206,947,1400000US17037000900,"Census Tract 9,DeKalb County",17|037|000900,Illinois
1502,3245,28,3217,1400000US17037001002,"Census Tract 10,02,DeKalb County",17|037|001002,Illinois
1503,1562,0,1562,1400000US17037001003,"Census Tract 10,03,DeKalb County",17|037|001003,Illinois
1504,680,426,254,1400000US17037001004,"Census Tract 10,04,DeKalb County",17|037|001004,Illinois
1505,2356,838,1518,1400000US17037001300,"Census Tract 13,DeKalb County",17|037|001300,Illinois
1506,2471,1717,754,1400000US17037001400,"Census Tract 14,DeKalb County",17|037|001400,Illinois
1507,1446,1089,357,1400000US17037001500,"Census Tract 15,DeKalb County",17|037|001500,Illinois
1508,1704,1375,329,1400000US17037001600,"Census Tract 16,DeKalb County",17|037|001600,Illinois
1509,1330,1039,291,1400000US17037001700,"Census Tract 17,DeKalb County",17|037|001700,Illinois
1510,1459,1140,319,1400000US17037001800,"Census Tract 18,DeKalb County",17|037|001800,Illinois
1511,899,695,204,1400000US17037001900,"Census Tract 19,DeKalb County",17|037|001900,Illinois
1512,1678,1277,401,1400000US17037002000,"Census Tract 20,DeKalb County",17|037|002000,Illinois
1513,919,543,376,1400000US17037002100,"Census Tract 21,DeKalb County",17|037|002100,Illinois
1514,352,22,330,1400000US17037002200,"Census Tract 22,DeKalb County",17|037|002200,Illinois
1515,990,824,166,1400000US17039971400,"Census Tract 9714,De Witt County",17|039|971400,Illinois
1516,1021,909,112,1400000US17039971500,"Census Tract 9715,De Witt County",17|039|971500,Illinois
1517,1552,1389,163,1400000US17039971600,"Census Tract 9716,De Witt County",17|039|971600,Illinois
1518,1542,1023,519,1400000US17039971700,"Census Tract 9717,De Witt County",17|039|971700,Illinois
1519,1530,928,602,1400000US17039971800,"Census Tract 9718,De Witt County",17|039|971800,Illinois
1520,965,879,86,1400000US17041952000,"Census Tract 9520,Douglas County",17|041|952000,Illinois
1521,1700,1367,333,1400000US17041952100,"Census Tract 9521,Douglas County",17|041|952100,Illinois
1522,2058,1388,670,1400000US17041952200,"Census Tract 9522,Douglas County",17|041|952200,Illinois
1523,1701,1364,337,1400000US17041952300,"Census Tract 9523,Douglas County",17|041|952300,Illinois
1524,1161,841,320,1400000US17041952400,"Census Tract 9524,Douglas County",17|041|952400,Illinois
1525,937,541,396,1400000US17043840000,"Census Tract 8400,DuPage County",17|043|840000,Illinois
1526,1812,1550,262,1400000US17043840101,"Census Tract 8401,01,DuPage County",17|043|840101,Illinois
1527,1706,1040,666,1400000US17043840102,"Census Tract 8401,02,DuPage County",17|043|840102,Illinois
1528,2195,1801,394,1400000US17043840103,"Census Tract 8401,03,DuPage County",17|043|840103,Illinois
1529,2236,1131,1105,1400000US17043840104,"Census Tract 8401,04,DuPage County",17|043|840104,Illinois
1530,2707,2352,355,1400000US17043840201,"Census Tract 8402,01,DuPage County",17|043|840201,Illinois
1531,1879,1810,69,1400000US17043840202,"Census Tract 8402,02,DuPage County",17|043|840202,Illinois
1532,1423,795,628,1400000US17043840303,"Census Tract 8403,03,DuPage County",17|043|840303,Illinois
1533,1453,1381,72,1400000US17043840304,"Census Tract 8403,04,DuPage County",17|043|840304,Illinois
1534,1822,1359,463,1400000US17043840600,"Census Tract 8406,DuPage County",17|043|840600,Illinois
1535,1632,605,1027,1400000US17043840703,"Census Tract 8407,03,DuPage County",17|043|840703,Illinois
1536,1208,474,734,1400000US17043840704,"Census Tract 8407,04,DuPage County",17|043|840704,Illinois
1537,1167,998,169,1400000US17043840705,"Census Tract 8407,05,DuPage County",17|043|840705,Illinois
1538,1169,1080,89,1400000US17043840706,"Census Tract 8407,06,DuPage County",17|043|840706,Illinois
1539,956,612,344,1400000US17043840801,"Census Tract 8408,01,DuPage County",17|043|840801,Illinois
1540,2159,1375,784,1400000US17043840802,"Census Tract 8408,02,DuPage County",17|043|840802,Illinois
1541,1590,832,758,1400000US17043840901,"Census Tract 8409,01,DuPage County",17|043|840901,Illinois
1542,1531,442,1089,1400000US17043840904,"Census Tract 8409,04,DuPage County",17|043|840904,Illinois
1543,1017,478,539,1400000US17043840906,"Census Tract 8409,06,DuPage County",17|043|840906,Illinois
1544,1973,1161,812,1400000US17043840907,"Census Tract 8409,07,DuPage County",17|043|840907,Illinois
1545,1524,948,576,1400000US17043840908,"Census Tract 8409,08,DuPage County",17|043|840908,Illinois
1546,1569,1226,343,1400000US17043840910,"Census Tract 8409,10,DuPage County",17|043|840910,Illinois
1547,814,744,70,1400000US17043840911,"Census Tract 8409,11,DuPage County",17|043|840911,Illinois
1548,1189,1069,120,1400000US17043841002,"Census Tract 8410,02,DuPage County",17|043|841002,Illinois
1549,1493,1128,365,1400000US17043841003,"Census Tract 8410,03,DuPage County",17|043|841003,Illinois
1550,1643,1184,459,1400000US17043841004,"Census Tract 8410,04,DuPage County",17|043|841004,Illinois
1551,2177,1615,562,1400000US17043841102,"Census Tract 8411,02,DuPage County",17|043|841102,Illinois
1552,1454,1322,132,1400000US17043841103,"Census Tract 8411,03,DuPage County",17|043|841103,Illinois
1553,1481,1367,114,1400000US17043841104,"Census Tract 8411,04,DuPage County",17|043|841104,Illinois
1554,1403,1131,272,1400000US17043841108,"Census Tract 8411,08,DuPage County",17|043|841108,Illinois
1555,1503,957,546,1400000US17043841109,"Census Tract 8411,09,DuPage County",17|043|841109,Illinois
1556,1316,1220,96,1400000US17043841110,"Census Tract 8411,10,DuPage County",17|043|841110,Illinois
1557,1507,1164,343,1400000US17043841111,"Census Tract 8411,11,DuPage County",17|043|841111,Illinois
1558,1228,852,376,1400000US17043841112,"Census Tract 8411,12,DuPage County",17|043|841112,Illinois
1559,1287,1023,264,1400000US17043841113,"Census Tract 8411,13,DuPage County",17|043|841113,Illinois
1560,1653,978,675,1400000US17043841114,"Census Tract 8411,14,DuPage County",17|043|841114,Illinois
1561,1767,1573,194,1400000US17043841204,"Census Tract 8412,04,DuPage County",17|043|841204,Illinois
1562,1499,1363,136,1400000US17043841205,"Census Tract 8412,05,DuPage County",17|043|841205,Illinois
1563,1992,1380,612,1400000US17043841206,"Census Tract 8412,06,DuPage County",17|043|841206,Illinois
1564,834,742,92,1400000US17043841207,"Census Tract 8412,07,DuPage County",17|043|841207,Illinois
1565,1869,1142,727,1400000US17043841208,"Census Tract 8412,08,DuPage County",17|043|841208,Illinois
1566,1569,1468,101,1400000US17043841209,"Census Tract 8412,09,DuPage County",17|043|841209,Illinois
1567,1675,595,1080,1400000US17043841210,"Census Tract 8412,10,DuPage County",17|043|841210,Illinois
1568,1873,1838,35,1400000US17043841307,"Census Tract 8413,07,DuPage County",17|043|841307,Illinois
1569,1576,1515,61,1400000US17043841308,"Census Tract 8413,08,DuPage County",17|043|841308,Illinois
1570,1059,1018,41,1400000US17043841310,"Census Tract 8413,10,DuPage County",17|043|841310,Illinois
1571,1258,722,536,1400000US17043841312,"Census Tract 8413,12,DuPage County",17|043|841312,Illinois
1572,1043,801,242,1400000US17043841313,"Census Tract 8413,13,DuPage County",17|043|841313,Illinois
1573,1996,1728,268,1400000US17043841314,"Census Tract 8413,14,DuPage County",17|043|841314,Illinois
1574,1056,672,384,1400000US17043841315,"Census Tract 8413,15,DuPage County",17|043|841315,Illinois
1575,1187,1156,31,1400000US17043841316,"Census Tract 8413,16,DuPage County",17|043|841316,Illinois
1576,937,906,31,1400000US17043841318,"Census Tract 8413,18,DuPage County",17|043|841318,Illinois
1577,887,736,151,1400000US17043841320,"Census Tract 8413,20,DuPage County",17|043|841320,Illinois
1578,823,745,78,1400000US17043841321,"Census Tract 8413,21,DuPage County",17|043|841321,Illinois
1579,1493,1353,140,1400000US17043841322,"Census Tract 8413,22,DuPage County",17|043|841322,Illinois
1580,1019,807,212,1400000US17043841323,"Census Tract 8413,23,DuPage County",17|043|841323,Illinois
1581,885,870,15,1400000US17043841324,"Census Tract 8413,24,DuPage County",17|043|841324,Illinois
1582,1891,1742,149,1400000US17043841325,"Census Tract 8413,25,DuPage County",17|043|841325,Illinois
1583,1223,1064,159,1400000US17043841326,"Census Tract 8413,26,DuPage County",17|043|841326,Illinois
1584,1285,1275,10,1400000US17043841327,"Census Tract 8413,27,DuPage County",17|043|841327,Illinois
1585,2075,1767,308,1400000US17043841401,"Census Tract 8414,01,DuPage County",17|043|841401,Illinois
1586,1548,1305,243,1400000US17043841403,"Census Tract 8414,03,DuPage County",17|043|841403,Illinois
1587,1270,1207,63,1400000US17043841404,"Census Tract 8414,04,DuPage County",17|043|841404,Illinois
1588,1595,1272,323,1400000US17043841501,"Census Tract 8415,01,DuPage County",17|043|841501,Illinois
1589,980,903,77,1400000US17043841503,"Census Tract 8415,03,DuPage County",17|043|841503,Illinois
1590,1105,611,494,1400000US17043841504,"Census Tract 8415,04,DuPage County",17|043|841504,Illinois
1591,1776,1218,558,1400000US17043841603,"Census Tract 8416,03,DuPage County",17|043|841603,Illinois
1592,1406,842,564,1400000US17043841604,"Census Tract 8416,04,DuPage County",17|043|841604,Illinois
1593,1217,1024,193,1400000US17043841605,"Census Tract 8416,05,DuPage County",17|043|841605,Illinois
1594,859,536,323,1400000US17043841606,"Census Tract 8416,06,DuPage County",17|043|841606,Illinois
1595,1813,1561,252,1400000US17043841607,"Census Tract 8416,07,DuPage County",17|043|841607,Illinois
1596,1568,1275,293,1400000US17043841704,"Census Tract 8417,04,DuPage County",17|043|841704,Illinois
1597,2442,1693,749,1400000US17043841705,"Census Tract 8417,05,DuPage County",17|043|841705,Illinois
1598,1515,846,669,1400000US17043841706,"Census Tract 8417,06,DuPage County",17|043|841706,Illinois
1599,1475,677,798,1400000US17043841707,"Census Tract 8417,07,DuPage County",17|043|841707,Illinois
1600,1734,474,1260,1400000US17043841708,"Census Tract 8417,08,DuPage County",17|043|841708,Illinois
1601,1872,1511,361,1400000US17043841801,"Census Tract 8418,01,DuPage County",17|043|841801,Illinois
1602,1913,1791,122,1400000US17043841802,"Census Tract 8418,02,DuPage County",17|043|841802,Illinois
1603,903,875,28,1400000US17043841901,"Census Tract 8419,01,DuPage County",17|043|841901,Illinois
1604,762,512,250,1400000US17043841902,"Census Tract 8419,02,DuPage County",17|043|841902,Illinois
1605,1468,1394,74,1400000US17043842000,"Census Tract 8420,DuPage County",17|043|842000,Illinois
1606,2319,1765,554,1400000US17043842100,"Census Tract 8421,DuPage County",17|043|842100,Illinois
1607,1968,1360,608,1400000US17043842200,"Census Tract 8422,DuPage County",17|043|842200,Illinois
1608,1238,1112,126,1400000US17043842300,"Census Tract 8423,DuPage County",17|043|842300,Illinois
1609,1715,1194,521,1400000US17043842400,"Census Tract 8424,DuPage County",17|043|842400,Illinois
1610,1685,871,814,1400000US17043842500,"Census Tract 8425,DuPage County",17|043|842500,Illinois
1611,1434,1171,263,1400000US17043842601,"Census Tract 8426,01,DuPage County",17|043|842601,Illinois
1612,1473,1473,0,1400000US17043842602,"Census Tract 8426,02,DuPage County",17|043|842602,Illinois
1613,1335,823,512,1400000US17043842603,"Census Tract 8426,03,DuPage County",17|043|842603,Illinois
1614,2025,1500,525,1400000US17043842604,"Census Tract 8426,04,DuPage County",17|043|842604,Illinois
1615,1542,1383,159,1400000US17043842605,"Census Tract 8426,05,DuPage County",17|043|842605,Illinois
1616,2015,1043,972,1400000US17043842702,"Census Tract 8427,02,DuPage County",17|043|842702,Illinois
1617,1458,1338,120,1400000US17043842703,"Census Tract 8427,03,DuPage County",17|043|842703,Illinois
1618,2144,1499,645,1400000US17043842704,"Census Tract 8427,04,DuPage County",17|043|842704,Illinois
1619,1812,1489,323,1400000US17043842706,"Census Tract 8427,06,DuPage County",17|043|842706,Illinois
1620,897,872,25,1400000US17043842708,"Census Tract 8427,08,DuPage County",17|043|842708,Illinois
1621,1231,974,257,1400000US17043842709,"Census Tract 8427,09,DuPage County",17|043|842709,Illinois
1622,1665,1204,461,1400000US17043842710,"Census Tract 8427,10,DuPage County",17|043|842710,Illinois
1623,927,864,63,1400000US17043842711,"Census Tract 8427,11,DuPage County",17|043|842711,Illinois
1624,1780,1539,241,1400000US17043842800,"Census Tract 8428,DuPage County",17|043|842800,Illinois
1625,2145,1280,865,1400000US17043842900,"Census Tract 8429,DuPage County",17|043|842900,Illinois
1626,1679,1221,458,1400000US17043843000,"Census Tract 8430,DuPage County",17|043|843000,Illinois
1627,1753,1022,731,1400000US17043843100,"Census Tract 8431,DuPage County",17|043|843100,Illinois
1628,2019,1391,628,1400000US17043843200,"Census Tract 8432,DuPage County",17|043|843200,Illinois
1629,1271,1036,235,1400000US17043843301,"Census Tract 8433,01,DuPage County",17|043|843301,Illinois
1630,1162,1068,94,1400000US17043843302,"Census Tract 8433,02,DuPage County",17|043|843302,Illinois
1631,1172,991,181,1400000US17043843400,"Census Tract 8434,DuPage County",17|043|843400,Illinois
1632,2137,1557,580,1400000US17043843500,"Census Tract 8435,DuPage County",17|043|843500,Illinois
1633,1295,973,322,1400000US17043843601,"Census Tract 8436,01,DuPage County",17|043|843601,Illinois
1634,1140,1024,116,1400000US17043843602,"Census Tract 8436,02,DuPage County",17|043|843602,Illinois
1635,1493,1404,89,1400000US17043843700,"Census Tract 8437,DuPage County",17|043|843700,Illinois
1636,1402,962,440,1400000US17043843800,"Census Tract 8438,DuPage County",17|043|843800,Illinois
1637,1466,1333,133,1400000US17043843900,"Census Tract 8439,DuPage County",17|043|843900,Illinois
1638,1261,1235,26,1400000US17043844001,"Census Tract 8440,01,DuPage County",17|043|844001,Illinois
1639,1351,1335,16,1400000US17043844002,"Census Tract 8440,02,DuPage County",17|043|844002,Illinois
1640,1344,1261,83,1400000US17043844100,"Census Tract 8441,DuPage County",17|043|844100,Illinois
1641,1922,1487,435,1400000US17043844201,"Census Tract 8442,01,DuPage County",17|043|844201,Illinois
1642,834,777,57,1400000US17043844202,"Census Tract 8442,02,DuPage County",17|043|844202,Illinois
1643,1678,793,885,1400000US17043844304,"Census Tract 8443,04,DuPage County",17|043|844304,Illinois
1644,1873,792,1081,1400000US17043844305,"Census Tract 8443,05,DuPage County",17|043|844305,Illinois
1645,2236,1317,919,1400000US17043844306,"Census Tract 8443,06,DuPage County",17|043|844306,Illinois
1646,1447,830,617,1400000US17043844307,"Census Tract 8443,07,DuPage County",17|043|844307,Illinois
1647,1307,674,633,1400000US17043844308,"Census Tract 8443,08,DuPage County",17|043|844308,Illinois
1648,799,650,149,1400000US17043844309,"Census Tract 8443,09,DuPage County",17|043|844309,Illinois
1649,1289,775,514,1400000US17043844310,"Census Tract 8443,10,DuPage County",17|043|844310,Illinois
1650,1328,1209,119,1400000US17043844401,"Census Tract 8444,01,DuPage County",17|043|844401,Illinois
1651,1710,1125,585,1400000US17043844402,"Census Tract 8444,02,DuPage County",17|043|844402,Illinois
1652,1237,991,246,1400000US17043844501,"Census Tract 8445,01,DuPage County",17|043|844501,Illinois
1653,1605,934,671,1400000US17043844502,"Census Tract 8445,02,DuPage County",17|043|844502,Illinois
1654,1595,1402,193,1400000US17043844601,"Census Tract 8446,01,DuPage County",17|043|844601,Illinois
1655,2283,1522,761,1400000US17043844602,"Census Tract 8446,02,DuPage County",17|043|844602,Illinois
1656,1606,1344,262,1400000US17043844701,"Census Tract 8447,01,DuPage County",17|043|844701,Illinois
1657,1860,1595,265,1400000US17043844702,"Census Tract 8447,02,DuPage County",17|043|844702,Illinois
1658,1531,1330,201,1400000US17043844801,"Census Tract 8448,01,DuPage County",17|043|844801,Illinois
1659,1437,1118,319,1400000US17043844802,"Census Tract 8448,02,DuPage County",17|043|844802,Illinois
1660,1499,1023,476,1400000US17043844901,"Census Tract 8449,01,DuPage County",17|043|844901,Illinois
1661,1689,1200,489,1400000US17043844902,"Census Tract 8449,02,DuPage County",17|043|844902,Illinois
1662,2395,1678,717,1400000US17043845000,"Census Tract 8450,DuPage County",17|043|845000,Illinois
1663,2034,1860,174,1400000US17043845100,"Census Tract 8451,DuPage County",17|043|845100,Illinois
1664,1576,1448,128,1400000US17043845200,"Census Tract 8452,DuPage County",17|043|845200,Illinois
1665,953,910,43,1400000US17043845300,"Census Tract 8453,DuPage County",17|043|845300,Illinois
1666,1386,1215,171,1400000US17043845401,"Census Tract 8454,01,DuPage County",17|043|845401,Illinois
1667,1244,979,265,1400000US17043845402,"Census Tract 8454,02,DuPage County",17|043|845402,Illinois
1668,2488,1309,1179,1400000US17043845502,"Census Tract 8455,02,DuPage County",17|043|845502,Illinois
1669,1459,1044,415,1400000US17043845505,"Census Tract 8455,05,DuPage County",17|043|845505,Illinois
1670,1674,997,677,1400000US17043845506,"Census Tract 8455,06,DuPage County",17|043|845506,Illinois
1671,1310,1194,116,1400000US17043845507,"Census Tract 8455,07,DuPage County",17|043|845507,Illinois
1672,1764,1500,264,1400000US17043845508,"Census Tract 8455,08,DuPage County",17|043|845508,Illinois
1673,1300,1140,160,1400000US17043845509,"Census Tract 8455,09,DuPage County",17|043|845509,Illinois
1674,1538,531,1007,1400000US17043845510,"Census Tract 8455,10,DuPage County",17|043|845510,Illinois
1675,1704,1087,617,1400000US17043845601,"Census Tract 8456,01,DuPage County",17|043|845601,Illinois
1676,1991,1309,682,1400000US17043845602,"Census Tract 8456,02,DuPage County",17|043|845602,Illinois
1677,1669,1458,211,1400000US17043845701,"Census Tract 8457,01,DuPage County",17|043|845701,Illinois
1678,1631,1560,71,1400000US17043845702,"Census Tract 8457,02,DuPage County",17|043|845702,Illinois
1679,1866,1188,678,1400000US17043845703,"Census Tract 8457,03,DuPage County",17|043|845703,Illinois
1680,2125,1321,804,1400000US17043845704,"Census Tract 8457,04,DuPage County",17|043|845704,Illinois
1681,1611,1542,69,1400000US17043845802,"Census Tract 8458,02,DuPage County",17|043|845802,Illinois
1682,2197,1577,620,1400000US17043845803,"Census Tract 8458,03,DuPage County",17|043|845803,Illinois
1683,1713,1443,270,1400000US17043845805,"Census Tract 8458,05,DuPage County",17|043|845805,Illinois
1684,2632,2106,526,1400000US17043845807,"Census Tract 8458,07,DuPage County",17|043|845807,Illinois
1685,1296,1296,0,1400000US17043845808,"Census Tract 8458,08,DuPage County",17|043|845808,Illinois
1686,1643,1425,218,1400000US17043845809,"Census Tract 8458,09,DuPage County",17|043|845809,Illinois
1687,1747,966,781,1400000US17043845810,"Census Tract 8458,10,DuPage County",17|043|845810,Illinois
1688,1402,922,480,1400000US17043845811,"Census Tract 8458,11,DuPage County",17|043|845811,Illinois
1689,1182,1121,61,1400000US17043845901,"Census Tract 8459,01,DuPage County",17|043|845901,Illinois
1690,1245,1088,157,1400000US17043845902,"Census Tract 8459,02,DuPage County",17|043|845902,Illinois
1691,2613,1985,628,1400000US17043846002,"Census Tract 8460,02,DuPage County",17|043|846002,Illinois
1692,1856,1211,645,1400000US17043846003,"Census Tract 8460,03,DuPage County",17|043|846003,Illinois
1693,1634,731,903,1400000US17043846004,"Census Tract 8460,04,DuPage County",17|043|846004,Illinois
1694,1973,734,1239,1400000US17043846102,"Census Tract 8461,02,DuPage County",17|043|846102,Illinois
1695,1862,1283,579,1400000US17043846103,"Census Tract 8461,03,DuPage County",17|043|846103,Illinois
1696,1464,1266,198,1400000US17043846104,"Census Tract 8461,04,DuPage County",17|043|846104,Illinois
1697,1422,1161,261,1400000US17043846105,"Census Tract 8461,05,DuPage County",17|043|846105,Illinois
1698,1592,971,621,1400000US17043846106,"Census Tract 8461,06,DuPage County",17|043|846106,Illinois
1699,2334,1927,407,1400000US17043846201,"Census Tract 8462,01,DuPage County",17|043|846201,Illinois
1700,2339,1485,854,1400000US17043846202,"Census Tract 8462,02,DuPage County",17|043|846202,Illinois
1701,1487,1420,67,1400000US17043846203,"Census Tract 8462,03,DuPage County",17|043|846203,Illinois
1702,1213,1118,95,1400000US17043846205,"Census Tract 8462,05,DuPage County",17|043|846205,Illinois
1703,1457,1143,314,1400000US17043846206,"Census Tract 8462,06,DuPage County",17|043|846206,Illinois
1704,1888,1802,86,1400000US17043846207,"Census Tract 8462,07,DuPage County",17|043|846207,Illinois
1705,1180,1135,45,1400000US17043846208,"Census Tract 8462,08,DuPage County",17|043|846208,Illinois
1706,1304,1119,185,1400000US17043846209,"Census Tract 8462,09,DuPage County",17|043|846209,Illinois
1707,1980,1680,300,1400000US17043846304,"Census Tract 8463,04,DuPage County",17|043|846304,Illinois
1708,2057,1747,310,1400000US17043846305,"Census Tract 8463,05,DuPage County",17|043|846305,Illinois
1709,1932,1094,838,1400000US17043846307,"Census Tract 8463,07,DuPage County",17|043|846307,Illinois
1710,1544,908,636,1400000US17043846308,"Census Tract 8463,08,DuPage County",17|043|846308,Illinois
1711,1630,703,927,1400000US17043846310,"Census Tract 8463,10,DuPage County",17|043|846310,Illinois
1712,2008,1284,724,1400000US17043846311,"Census Tract 8463,11,DuPage County",17|043|846311,Illinois
1713,2802,1270,1532,1400000US17043846312,"Census Tract 8463,12,DuPage County",17|043|846312,Illinois
1714,2233,1420,813,1400000US17043846313,"Census Tract 8463,13,DuPage County",17|043|846313,Illinois
1715,1619,996,623,1400000US17043846314,"Census Tract 8463,14,DuPage County",17|043|846314,Illinois
1716,1495,1425,70,1400000US17043846315,"Census Tract 8463,15,DuPage County",17|043|846315,Illinois
1717,2709,1373,1336,1400000US17043846404,"Census Tract 8464,04,DuPage County",17|043|846404,Illinois
1718,1603,1376,227,1400000US17043846405,"Census Tract 8464,05,DuPage County",17|043|846405,Illinois
1719,1361,1182,179,1400000US17043846408,"Census Tract 8464,08,DuPage County",17|043|846408,Illinois
1720,1662,1469,193,1400000US17043846409,"Census Tract 8464,09,DuPage County",17|043|846409,Illinois
1721,2254,823,1431,1400000US17043846410,"Census Tract 8464,10,DuPage County",17|043|846410,Illinois
1722,2077,750,1327,1400000US17043846411,"Census Tract 8464,11,DuPage County",17|043|846411,Illinois
1723,1841,1007,834,1400000US17043846412,"Census Tract 8464,12,DuPage County",17|043|846412,Illinois
1724,1535,635,900,1400000US17043846413,"Census Tract 8464,13,DuPage County",17|043|846413,Illinois
1725,2333,1286,1047,1400000US17043846504,"Census Tract 8465,04,DuPage County",17|043|846504,Illinois
1726,1392,657,735,1400000US17043846507,"Census Tract 8465,07,DuPage County",17|043|846507,Illinois
1727,2462,1302,1160,1400000US17043846509,"Census Tract 8465,09,DuPage County",17|043|846509,Illinois
1728,1424,643,781,1400000US17043846510,"Census Tract 8465,10,DuPage County",17|043|846510,Illinois
1729,1890,1529,361,1400000US17043846511,"Census Tract 8465,11,DuPage County",17|043|846511,Illinois
1730,1017,913,104,1400000US17043846513,"Census Tract 8465,13,DuPage County",17|043|846513,Illinois
1731,1336,905,431,1400000US17043846514,"Census Tract 8465,14,DuPage County",17|043|846514,Illinois
1732,1733,1302,431,1400000US17043846515,"Census Tract 8465,15,DuPage County",17|043|846515,Illinois
1733,1941,1391,550,1400000US17043846517,"Census Tract 8465,17,DuPage County",17|043|846517,Illinois
1734,1099,1055,44,1400000US17043846518,"Census Tract 8465,18,DuPage County",17|043|846518,Illinois
1735,1335,645,690,1400000US17043846519,"Census Tract 8465,19,DuPage County",17|043|846519,Illinois
1736,1804,1412,392,1400000US17043846521,"Census Tract 8465,21,DuPage County",17|043|846521,Illinois
1737,1473,1029,444,1400000US17043846522,"Census Tract 8465,22,DuPage County",17|043|846522,Illinois
1738,896,822,74,1400000US17043846523,"Census Tract 8465,23,DuPage County",17|043|846523,Illinois
1739,1761,1206,555,1400000US17043846524,"Census Tract 8465,24,DuPage County",17|043|846524,Illinois
1740,1235,776,459,1400000US17043846603,"Census Tract 8466,03,DuPage County",17|043|846603,Illinois
1741,1463,1125,338,1400000US17043846604,"Census Tract 8466,04,DuPage County",17|043|846604,Illinois
1742,1473,820,653,1400000US17043846701,"Census Tract 8467,01,DuPage County",17|043|846701,Illinois
1743,1260,966,294,1400000US17043846702,"Census Tract 8467,02,DuPage County",17|043|846702,Illinois
1744,984,727,257,1400000US17045070100,"Census Tract 701,Edgar County",17|045|070100,Illinois
1745,789,591,198,1400000US17045070200,"Census Tract 702,Edgar County",17|045|070200,Illinois
1746,1708,1396,312,1400000US17045070300,"Census Tract 703,Edgar County",17|045|070300,Illinois
1747,2578,1463,1115,1400000US17045070400,"Census Tract 704,Edgar County",17|045|070400,Illinois
1748,1485,1272,213,1400000US17045070500,"Census Tract 705,Edgar County",17|045|070500,Illinois
1749,839,720,119,1400000US17047956900,"Census Tract 9569,Edwards County",17|047|956900,Illinois
1750,926,787,139,1400000US17047957000,"Census Tract 9570,Edwards County",17|047|957000,Illinois
1751,891,607,284,1400000US17047957100,"Census Tract 9571,Edwards County",17|047|957100,Illinois
1752,1644,1327,317,1400000US17049950100,"Census Tract 9501,Effingham County",17|049|950100,Illinois
1753,1923,1639,284,1400000US17049950200,"Census Tract 9502,Effingham County",17|049|950200,Illinois
1754,1791,1461,330,1400000US17049950300,"Census Tract 9503,Effingham County",17|049|950300,Illinois
1755,1513,1339,174,1400000US17049950400,"Census Tract 9504,Effingham County",17|049|950400,Illinois
1756,1778,1594,184,1400000US17049950500,"Census Tract 9505,Effingham County",17|049|950500,Illinois
1757,2260,1759,501,1400000US17049950600,"Census Tract 9506,Effingham County",17|049|950600,Illinois
1758,1492,815,677,1400000US17049950700,"Census Tract 9507,Effingham County",17|049|950700,Illinois
1759,1703,885,818,1400000US17049950800,"Census Tract 9508,Effingham County",17|049|950800,Illinois
1760,1071,973,98,1400000US17051950500,"Census Tract 9505,Fayette County",17|051|950500,Illinois
1761,925,694,231,1400000US17051950600,"Census Tract 9506,Fayette County",17|051|950600,Illinois
1762,1560,1397,163,1400000US17051950700,"Census Tract 9507,Fayette County",17|051|950700,Illinois
1763,1386,924,462,1400000US17051950800,"Census Tract 9508,Fayette County",17|051|950800,Illinois
1764,757,397,360,1400000US17051950900,"Census Tract 9509,Fayette County",17|051|950900,Illinois
1765,782,641,141,1400000US17051951000,"Census Tract 9510,Fayette County",17|051|951000,Illinois
1766,1128,953,175,1400000US17051951100,"Census Tract 9511,Fayette County",17|051|951100,Illinois
1767,863,627,236,1400000US17053961600,"Census Tract 9616,Ford County",17|053|961600,Illinois
1768,770,633,137,1400000US17053961700,"Census Tract 9617,Ford County",17|053|961700,Illinois
1769,1791,1348,443,1400000US17053961800,"Census Tract 9618,Ford County",17|053|961800,Illinois
1770,646,542,104,1400000US17053961900,"Census Tract 9619,Ford County",17|053|961900,Illinois
1771,1649,1209,440,1400000US17053962000,"Census Tract 9620,Ford County",17|053|962000,Illinois
1772,1093,950,143,1400000US17055040100,"Census Tract 401,Franklin County",17|055|040100,Illinois
1773,1351,1202,149,1400000US17055040200,"Census Tract 402,Franklin County",17|055|040200,Illinois
1774,1353,927,426,1400000US17055040300,"Census Tract 403,Franklin County",17|055|040300,Illinois
1775,1587,1210,377,1400000US17055040400,"Census Tract 404,Franklin County",17|055|040400,Illinois
1776,1290,826,464,1400000US17055040500,"Census Tract 405,Franklin County",17|055|040500,Illinois
1777,1178,763,415,1400000US17055040600,"Census Tract 406,Franklin County",17|055|040600,Illinois
1778,1909,1431,478,1400000US17055040700,"Census Tract 407,Franklin County",17|055|040700,Illinois
1779,1423,1294,129,1400000US17055040800,"Census Tract 408,Franklin County",17|055|040800,Illinois
1780,1039,667,372,1400000US17055040900,"Census Tract 409,Franklin County",17|055|040900,Illinois
1781,1181,619,562,1400000US17055041000,"Census Tract 410,Franklin County",17|055|041000,Illinois
1782,1282,958,324,1400000US17055041100,"Census Tract 411,Franklin County",17|055|041100,Illinois
1783,1551,1269,282,1400000US17055041200,"Census Tract 412,Franklin County",17|055|041200,Illinois
1784,1010,672,338,1400000US17057952800,"Census Tract 9528,Fulton County",17|057|952800,Illinois
1785,1274,1211,63,1400000US17057952900,"Census Tract 9529,Fulton County",17|057|952900,Illinois
1786,913,795,118,1400000US17057953000,"Census Tract 9530,Fulton County",17|057|953000,Illinois
1787,948,826,122,1400000US17057953100,"Census Tract 9531,Fulton County",17|057|953100,Illinois
1788,1029,831,198,1400000US17057953200,"Census Tract 9532,Fulton County",17|057|953200,Illinois
1789,1590,1290,300,1400000US17057953300,"Census Tract 9533,Fulton County",17|057|953300,Illinois
1790,756,390,366,1400000US17057953400,"Census Tract 9534,Fulton County",17|057|953400,Illinois
1791,1017,781,236,1400000US17057953500,"Census Tract 9535,Fulton County",17|057|953500,Illinois
1792,2190,1402,788,1400000US17057953600,"Census Tract 9536,Fulton County",17|057|953600,Illinois
1793,1022,900,122,1400000US17057953700,"Census Tract 9537,Fulton County",17|057|953700,Illinois
1794,988,767,221,1400000US17057953800,"Census Tract 9538,Fulton County",17|057|953800,Illinois
1795,1156,942,214,1400000US17057953900,"Census Tract 9539,Fulton County",17|057|953900,Illinois
1796,1021,845,176,1400000US17059972700,"Census Tract 9727,Gallatin County",17|059|972700,Illinois
1797,1112,842,270,1400000US17059972800,"Census Tract 9728,Gallatin County",17|059|972800,Illinois
1798,1029,849,180,1400000US17061973600,"Census Tract 9736,Greene County",17|061|973600,Illinois
1799,631,508,123,1400000US17061973700,"Census Tract 9737,Greene County",17|061|973700,Illinois
1800,684,593,91,1400000US17061973800,"Census Tract 9738,Greene County",17|061|973800,Illinois
1801,893,667,226,1400000US17061973900,"Census Tract 9739,Greene County",17|061|973900,Illinois
1802,1275,927,348,1400000US17061974000,"Census Tract 9740,Greene County",17|061|974000,Illinois
1803,2775,2402,373,1400000US17063000102,"Census Tract 1,02,Grundy County",17|063|000102,Illinois
1804,2436,2008,428,1400000US17063000103,"Census Tract 1,03,Grundy County",17|063|000103,Illinois
1805,2727,1697,1030,1400000US17063000200,"Census Tract 2,Grundy County",17|063|000200,Illinois
1806,1453,823,630,1400000US17063000300,"Census Tract 3,Grundy County",17|063|000300,Illinois
1807,2498,1369,1129,1400000US17063000400,"Census Tract 4,Grundy County",17|063|000400,Illinois
1808,1138,933,205,1400000US17063000500,"Census Tract 5,Grundy County",17|063|000500,Illinois
1809,1150,935,215,1400000US17063000600,"Census Tract 6,Grundy County",17|063|000600,Illinois
1810,2563,1977,586,1400000US17063000700,"Census Tract 7,Grundy County",17|063|000700,Illinois
1811,2028,1684,344,1400000US17063000800,"Census Tract 8,Grundy County",17|063|000800,Illinois
1812,1391,1097,294,1400000US17063000900,"Census Tract 9,Grundy County",17|063|000900,Illinois
1813,1214,846,368,1400000US17065973100,"Census Tract 9731,Hamilton County",17|065|973100,Illinois
1814,945,716,229,1400000US17065973200,"Census Tract 9732,Hamilton County",17|065|973200,Illinois
1815,1031,919,112,1400000US17065973300,"Census Tract 9733,Hamilton County",17|065|973300,Illinois
1816,856,737,119,1400000US17067953700,"Census Tract 9537,Hancock County",17|067|953700,Illinois
1817,1260,950,310,1400000US17067953800,"Census Tract 9538,Hancock County",17|067|953800,Illinois
1818,765,629,136,1400000US17067953900,"Census Tract 9539,Hancock County",17|067|953900,Illinois
1819,820,677,143,1400000US17067954000,"Census Tract 9540,Hancock County",17|067|954000,Illinois
1820,1250,934,316,1400000US17067954100,"Census Tract 9541,Hancock County",17|067|954100,Illinois
1821,996,878,118,1400000US17067954200,"Census Tract 9542,Hancock County",17|067|954200,Illinois
1822,1421,1223,198,1400000US17067954300,"Census Tract 9543,Hancock County",17|067|954300,Illinois
1823,764,611,153,1400000US17069970900,"Census Tract 9709,Hardin County",17|069|970900,Illinois
1824,737,553,184,1400000US17069971000,"Census Tract 9710,Hardin County",17|069|971000,Illinois
1825,957,843,114,1400000US17071973300,"Census Tract 9733,Henderson County",17|071|973300,Illinois
1826,800,698,102,1400000US17071973400,"Census Tract 9734,Henderson County",17|071|973400,Illinois
1827,939,757,182,1400000US17071973500,"Census Tract 9735,Henderson County",17|071|973500,Illinois
1828,2457,2001,456,1400000US17073030100,"Census Tract 301,Henry County",17|073|030100,Illinois
1829,1609,1386,223,1400000US17073030201,"Census Tract 302,01,Henry County",17|073|030201,Illinois
1830,1316,1151,165,1400000US17073030202,"Census Tract 302,02,Henry County",17|073|030202,Illinois
1831,1761,1707,54,1400000US17073030203,"Census Tract 302,03,Henry County",17|073|030203,Illinois
1832,1724,1387,337,1400000US17073030301,"Census Tract 303,01,Henry County",17|073|030301,Illinois
1833,1466,1072,394,1400000US17073030302,"Census Tract 303,02,Henry County",17|073|030302,Illinois
1834,1128,966,162,1400000US17073030400,"Census Tract 304,Henry County",17|073|030400,Illinois
1835,882,709,173,1400000US17073030500,"Census Tract 305,Henry County",17|073|030500,Illinois
1836,1255,982,273,1400000US17073030600,"Census Tract 306,Henry County",17|073|030600,Illinois
1837,1193,625,568,1400000US17073030800,"Census Tract 308,Henry County",17|073|030800,Illinois
1838,1620,1142,478,1400000US17073030900,"Census Tract 309,Henry County",17|073|030900,Illinois
1839,1361,1024,337,1400000US17073031000,"Census Tract 310,Henry County",17|073|031000,Illinois
1840,1105,883,222,1400000US17073031100,"Census Tract 311,Henry County",17|073|031100,Illinois
1841,1232,983,249,1400000US17073031200,"Census Tract 312,Henry County",17|073|031200,Illinois
1842,1151,971,180,1400000US17075950100,"Census Tract 9501,Iroquois County",17|075|950100,Illinois
1843,1496,1145,351,1400000US17075950200,"Census Tract 9502,Iroquois County",17|075|950200,Illinois
1844,1243,974,269,1400000US17075950300,"Census Tract 9503,Iroquois County",17|075|950300,Illinois
1845,1514,818,696,1400000US17075950400,"Census Tract 9504,Iroquois County",17|075|950400,Illinois
1846,1658,1344,314,1400000US17075950500,"Census Tract 9505,Iroquois County",17|075|950500,Illinois
1847,1154,969,185,1400000US17075950600,"Census Tract 9506,Iroquois County",17|075|950600,Illinois
1848,1123,1036,87,1400000US17075950700,"Census Tract 9507,Iroquois County",17|075|950700,Illinois
1849,958,769,189,1400000US17075950800,"Census Tract 9508,Iroquois County",17|075|950800,Illinois
1850,945,708,237,1400000US17075950900,"Census Tract 9509,Iroquois County",17|075|950900,Illinois
1851,1129,1016,113,1400000US17077010100,"Census Tract 101,Jackson County",17|077|010100,Illinois
1852,1577,967,610,1400000US17077010200,"Census Tract 102,Jackson County",17|077|010200,Illinois
1853,1070,871,199,1400000US17077010300,"Census Tract 103,Jackson County",17|077|010300,Illinois
1854,1957,1343,614,1400000US17077010400,"Census Tract 104,Jackson County",17|077|010400,Illinois
1855,817,633,184,1400000US17077010601,"Census Tract 106,01,Jackson County",17|077|010601,Illinois
1856,1387,770,617,1400000US17077010602,"Census Tract 106,02,Jackson County",17|077|010602,Illinois
1857,1440,628,812,1400000US17077010700,"Census Tract 107,Jackson County",17|077|010700,Illinois
1858,1628,705,923,1400000US17077010800,"Census Tract 108,Jackson County",17|077|010800,Illinois
1859,920,553,367,1400000US17077010900,"Census Tract 109,Jackson County",17|077|010900,Illinois
1860,741,427,314,1400000US17077011001,"Census Tract 110,01,Jackson County",17|077|011001,Illinois
1861,2020,1297,723,1400000US17077011002,"Census Tract 110,02,Jackson County",17|077|011002,Illinois
1862,1709,72,1637,1400000US17077011100,"Census Tract 111,Jackson County",17|077|011100,Illinois
1863,2266,355,1911,1400000US17077011200,"Census Tract 112,Jackson County",17|077|011200,Illinois
1864,1708,197,1511,1400000US17077011400,"Census Tract 114,Jackson County",17|077|011400,Illinois
1865,1392,1090,302,1400000US17077011600,"Census Tract 116,Jackson County",17|077|011600,Illinois
1866,840,371,469,1400000US17077011701,"Census Tract 117,01,Jackson County",17|077|011701,Illinois
1867,585,110,475,1400000US17077011702,"Census Tract 117,02,Jackson County",17|077|011702,Illinois
1868,1092,970,122,1400000US17079977300,"Census Tract 9773,Jasper County",17|079|977300,Illinois
1869,1283,908,375,1400000US17079977400,"Census Tract 9774,Jasper County",17|079|977400,Illinois
1870,1370,1247,123,1400000US17079977500,"Census Tract 9775,Jasper County",17|079|977500,Illinois
1871,1634,1391,243,1400000US17081050100,"Census Tract 501,Jefferson County",17|081|050100,Illinois
1872,1140,958,182,1400000US17081050200,"Census Tract 502,Jefferson County",17|081|050200,Illinois
1873,1704,1454,250,1400000US17081050300,"Census Tract 503,Jefferson County",17|081|050300,Illinois
1874,1394,1177,217,1400000US17081050400,"Census Tract 504,Jefferson County",17|081|050400,Illinois
1875,1793,649,1144,1400000US17081050500,"Census Tract 505,Jefferson County",17|081|050500,Illinois
1876,1240,939,301,1400000US17081050600,"Census Tract 506,Jefferson County",17|081|050600,Illinois
1877,1484,1149,335,1400000US17081050700,"Census Tract 507,Jefferson County",17|081|050700,Illinois
1878,1733,1469,264,1400000US17081050800,"Census Tract 508,Jefferson County",17|081|050800,Illinois
1879,1129,516,613,1400000US17081050900,"Census Tract 509,Jefferson County",17|081|050900,Illinois
1880,526,107,419,1400000US17081051000,"Census Tract 510,Jefferson County",17|081|051000,Illinois
1881,831,646,185,1400000US17081051100,"Census Tract 511,Jefferson County",17|081|051100,Illinois
1882,1853,1142,711,1400000US17083010100,"Census Tract 101,Jersey County",17|083|010100,Illinois
1883,1149,1107,42,1400000US17083010200,"Census Tract 102,Jersey County",17|083|010200,Illinois
1884,1167,1029,138,1400000US17083010300,"Census Tract 103,Jersey County",17|083|010300,Illinois
1885,2379,1932,447,1400000US17083010401,"Census Tract 104,01,Jersey County",17|083|010401,Illinois
1886,716,624,92,1400000US17083010402,"Census Tract 104,02,Jersey County",17|083|010402,Illinois
1887,554,500,54,1400000US17083010500,"Census Tract 105,Jersey County",17|083|010500,Illinois
1888,889,779,110,1400000US17085020101,"Census Tract 201,01,Jo Daviess County",17|085|020101,Illinois
1889,1021,846,175,1400000US17085020102,"Census Tract 201,02,Jo Daviess County",17|085|020102,Illinois
1890,2015,1529,486,1400000US17085020200,"Census Tract 202,Jo Daviess County",17|085|020200,Illinois
1891,2439,1805,634,1400000US17085020300,"Census Tract 203,Jo Daviess County",17|085|020300,Illinois
1892,938,908,30,1400000US17085020401,"Census Tract 204,01,Jo Daviess County",17|085|020401,Illinois
1893,1357,966,391,1400000US17085020402,"Census Tract 204,02,Jo Daviess County",17|085|020402,Illinois
1894,1347,1080,267,1400000US17085020500,"Census Tract 205,Jo Daviess County",17|085|020500,Illinois
1895,1602,1524,78,1400000US17087977600,"Census Tract 9776,Johnson County",17|087|977600,Illinois
1896,1179,1040,139,1400000US17087977700,"Census Tract 9777,Johnson County",17|087|977700,Illinois
1897,1268,888,380,1400000US17087977800,"Census Tract 9778,Johnson County",17|087|977800,Illinois
1898,6,6,0,1400000US17087980000,"Census Tract 9800,Johnson County",17|087|980000,Illinois
1899,2444,2005,439,1400000US17089850101,"Census Tract 8501,01,Kane County",17|089|850101,Illinois
1900,2072,1922,150,1400000US17089850103,"Census Tract 8501,03,Kane County",17|089|850103,Illinois
1901,2567,2179,388,1400000US17089850105,"Census Tract 8501,05,Kane County",17|089|850105,Illinois
1902,2537,2252,285,1400000US17089850106,"Census Tract 8501,06,Kane County",17|089|850106,Illinois
1903,1102,963,139,1400000US17089850201,"Census Tract 8502,01,Kane County",17|089|850201,Illinois
1904,1715,1192,523,1400000US17089850202,"Census Tract 8502,02,Kane County",17|089|850202,Illinois
1905,2056,1247,809,1400000US17089850301,"Census Tract 8503,01,Kane County",17|089|850301,Illinois
1906,1529,709,820,1400000US17089850302,"Census Tract 8503,02,Kane County",17|089|850302,Illinois
1907,1130,785,345,1400000US17089850400,"Census Tract 8504,Kane County",17|089|850400,Illinois
1908,1741,920,821,1400000US17089850500,"Census Tract 8505,Kane County",17|089|850500,Illinois
1909,2839,2232,607,1400000US17089850600,"Census Tract 8506,Kane County",17|089|850600,Illinois
1910,840,696,144,1400000US17089850703,"Census Tract 8507,03,Kane County",17|089|850703,Illinois
1911,3265,2884,381,1400000US17089850704,"Census Tract 8507,04,Kane County",17|089|850704,Illinois
1912,2537,1849,688,1400000US17089850705,"Census Tract 8507,05,Kane County",17|089|850705,Illinois
1913,830,777,53,1400000US17089850706,"Census Tract 8507,06,Kane County",17|089|850706,Illinois
1914,3220,3014,206,1400000US17089850707,"Census Tract 8507,07,Kane County",17|089|850707,Illinois
1915,1441,1119,322,1400000US17089850708,"Census Tract 8507,08,Kane County",17|089|850708,Illinois
1916,1471,1471,0,1400000US17089850709,"Census Tract 8507,09,Kane County",17|089|850709,Illinois
1917,2184,1847,337,1400000US17089850710,"Census Tract 8507,10,Kane County",17|089|850710,Illinois
1918,1325,1115,210,1400000US17089850711,"Census Tract 8507,11,Kane County",17|089|850711,Illinois
1919,2201,1714,487,1400000US17089850800,"Census Tract 8508,Kane County",17|089|850800,Illinois
1920,2696,1581,1115,1400000US17089851000,"Census Tract 8510,Kane County",17|089|851000,Illinois
1921,1354,827,527,1400000US17089851101,"Census Tract 8511,01,Kane County",17|089|851101,Illinois
1922,1349,907,442,1400000US17089851102,"Census Tract 8511,02,Kane County",17|089|851102,Illinois
1923,1196,569,627,1400000US17089851301,"Census Tract 8513,01,Kane County",17|089|851301,Illinois
1924,842,455,387,1400000US17089851302,"Census Tract 8513,02,Kane County",17|089|851302,Illinois
1925,1890,1168,722,1400000US17089851400,"Census Tract 8514,Kane County",17|089|851400,Illinois
1926,359,120,239,1400000US17089851500,"Census Tract 8515,Kane County",17|089|851500,Illinois
1927,2319,1285,1034,1400000US17089851600,"Census Tract 8516,Kane County",17|089|851600,Illinois
1928,2745,2348,397,1400000US17089851801,"Census Tract 8518,01,Kane County",17|089|851801,Illinois
1929,2605,1855,750,1400000US17089851904,"Census Tract 8519,04,Kane County",17|089|851904,Illinois
1930,3029,2397,632,1400000US17089851907,"Census Tract 8519,07,Kane County",17|089|851907,Illinois
1931,2054,1442,612,1400000US17089851908,"Census Tract 8519,08,Kane County",17|089|851908,Illinois
1932,1584,1163,421,1400000US17089851909,"Census Tract 8519,09,Kane County",17|089|851909,Illinois
1933,1487,1187,300,1400000US17089851910,"Census Tract 8519,10,Kane County",17|089|851910,Illinois
1934,1606,1550,56,1400000US17089851911,"Census Tract 8519,11,Kane County",17|089|851911,Illinois
1935,1225,1172,53,1400000US17089851912,"Census Tract 8519,12,Kane County",17|089|851912,Illinois
1936,2091,2020,71,1400000US17089851913,"Census Tract 8519,13,Kane County",17|089|851913,Illinois
1937,1790,1487,303,1400000US17089852001,"Census Tract 8520,01,Kane County",17|089|852001,Illinois
1938,2891,1817,1074,1400000US17089852002,"Census Tract 8520,02,Kane County",17|089|852002,Illinois
1939,979,794,185,1400000US17089852004,"Census Tract 8520,04,Kane County",17|089|852004,Illinois
1940,1878,1572,306,1400000US17089852005,"Census Tract 8520,05,Kane County",17|089|852005,Illinois
1941,2361,2344,17,1400000US17089852101,"Census Tract 8521,01,Kane County",17|089|852101,Illinois
1942,2298,2105,193,1400000US17089852103,"Census Tract 8521,03,Kane County",17|089|852103,Illinois
1943,927,815,112,1400000US17089852104,"Census Tract 8521,04,Kane County",17|089|852104,Illinois
1944,2025,1416,609,1400000US17089852201,"Census Tract 8522,01,Kane County",17|089|852201,Illinois
1945,1809,938,871,1400000US17089852203,"Census Tract 8522,03,Kane County",17|089|852203,Illinois
1946,1281,1245,36,1400000US17089852204,"Census Tract 8522,04,Kane County",17|089|852204,Illinois
1947,1091,415,676,1400000US17089852300,"Census Tract 8523,Kane County",17|089|852300,Illinois
1948,1997,1746,251,1400000US17089852403,"Census Tract 8524,03,Kane County",17|089|852403,Illinois
1949,927,862,65,1400000US17089852404,"Census Tract 8524,04,Kane County",17|089|852404,Illinois
1950,1266,1176,90,1400000US17089852405,"Census Tract 8524,05,Kane County",17|089|852405,Illinois
1951,890,873,17,1400000US17089852406,"Census Tract 8524,06,Kane County",17|089|852406,Illinois
1952,1146,1112,34,1400000US17089852407,"Census Tract 8524,07,Kane County",17|089|852407,Illinois
1953,1641,1532,109,1400000US17089852408,"Census Tract 8524,08,Kane County",17|089|852408,Illinois
1954,2513,2128,385,1400000US17089852500,"Census Tract 8525,Kane County",17|089|852500,Illinois
1955,1733,1434,299,1400000US17089852606,"Census Tract 8526,06,Kane County",17|089|852606,Illinois
1956,1389,1024,365,1400000US17089852607,"Census Tract 8526,07,Kane County",17|089|852607,Illinois
1957,1572,1177,395,1400000US17089852608,"Census Tract 8526,08,Kane County",17|089|852608,Illinois
1958,2898,1877,1021,1400000US17089852700,"Census Tract 8527,Kane County",17|089|852700,Illinois
1959,1633,1224,409,1400000US17089852803,"Census Tract 8528,03,Kane County",17|089|852803,Illinois
1960,2019,1795,224,1400000US17089852805,"Census Tract 8528,05,Kane County",17|089|852805,Illinois
1961,2401,2114,287,1400000US17089852806,"Census Tract 8528,06,Kane County",17|089|852806,Illinois
1962,1451,1131,320,1400000US17089852807,"Census Tract 8528,07,Kane County",17|089|852807,Illinois
1963,2632,2324,308,1400000US17089852808,"Census Tract 8528,08,Kane County",17|089|852808,Illinois
1964,2442,1426,1016,1400000US17089852903,"Census Tract 8529,03,Kane County",17|089|852903,Illinois
1965,684,528,156,1400000US17089852904,"Census Tract 8529,04,Kane County",17|089|852904,Illinois
1966,1377,812,565,1400000US17089852905,"Census Tract 8529,05,Kane County",17|089|852905,Illinois
1967,2084,1314,770,1400000US17089852906,"Census Tract 8529,06,Kane County",17|089|852906,Illinois
1968,1805,1369,436,1400000US17089852907,"Census Tract 8529,07,Kane County",17|089|852907,Illinois
1969,1397,1097,300,1400000US17089853001,"Census Tract 8530,01,Kane County",17|089|853001,Illinois
1970,1394,864,530,1400000US17089853004,"Census Tract 8530,04,Kane County",17|089|853004,Illinois
1971,2026,923,1103,1400000US17089853005,"Census Tract 8530,05,Kane County",17|089|853005,Illinois
1972,1185,783,402,1400000US17089853006,"Census Tract 8530,06,Kane County",17|089|853006,Illinois
1973,1622,769,853,1400000US17089853007,"Census Tract 8530,07,Kane County",17|089|853007,Illinois
1974,1207,834,373,1400000US17089853008,"Census Tract 8530,08,Kane County",17|089|853008,Illinois
1975,920,761,159,1400000US17089853100,"Census Tract 8531,Kane County",17|089|853100,Illinois
1976,1828,799,1029,1400000US17089853200,"Census Tract 8532,Kane County",17|089|853200,Illinois
1977,1218,835,383,1400000US17089853300,"Census Tract 8533,Kane County",17|089|853300,Illinois
1978,623,440,183,1400000US17089853401,"Census Tract 8534,01,Kane County",17|089|853401,Illinois
1979,1342,566,776,1400000US17089853402,"Census Tract 8534,02,Kane County",17|089|853402,Illinois
1980,1404,977,427,1400000US17089853500,"Census Tract 8535,Kane County",17|089|853500,Illinois
1981,753,254,499,1400000US17089853601,"Census Tract 8536,01,Kane County",17|089|853601,Illinois
1982,1174,708,466,1400000US17089853602,"Census Tract 8536,02,Kane County",17|089|853602,Illinois
1983,2062,1504,558,1400000US17089853900,"Census Tract 8539,Kane County",17|089|853900,Illinois
1984,1550,1243,307,1400000US17089854001,"Census Tract 8540,01,Kane County",17|089|854001,Illinois
1985,2120,1307,813,1400000US17089854002,"Census Tract 8540,02,Kane County",17|089|854002,Illinois
1986,1215,822,393,1400000US17089854100,"Census Tract 8541,Kane County",17|089|854100,Illinois
1987,1412,779,633,1400000US17089854200,"Census Tract 8542,Kane County",17|089|854200,Illinois
1988,1622,1071,551,1400000US17089854301,"Census Tract 8543,01,Kane County",17|089|854301,Illinois
1989,1383,958,425,1400000US17089854302,"Census Tract 8543,02,Kane County",17|089|854302,Illinois
1990,725,459,266,1400000US17089854401,"Census Tract 8544,01,Kane County",17|089|854401,Illinois
1991,1074,791,283,1400000US17089854402,"Census Tract 8544,02,Kane County",17|089|854402,Illinois
1992,2386,1100,1286,1400000US17089854403,"Census Tract 8544,03,Kane County",17|089|854403,Illinois
1993,3140,3059,81,1400000US17089854504,"Census Tract 8545,04,Kane County",17|089|854504,Illinois
1994,2569,2222,347,1400000US17089854505,"Census Tract 8545,05,Kane County",17|089|854505,Illinois
1995,1151,1131,20,1400000US17089854506,"Census Tract 8545,06,Kane County",17|089|854506,Illinois
1996,2061,1905,156,1400000US17089854507,"Census Tract 8545,07,Kane County",17|089|854507,Illinois
1997,2043,1784,259,1400000US17089854508,"Census Tract 8545,08,Kane County",17|089|854508,Illinois
1998,2287,1987,300,1400000US17089854509,"Census Tract 8545,09,Kane County",17|089|854509,Illinois
1999,1527,516,1011,1400000US17089854600,"Census Tract 8546,Kane County",17|089|854600,Illinois
2000,806,290,516,1400000US17089854700,"Census Tract 8547,Kane County",17|089|854700,Illinois
2001,2721,2467,254,1400000US17089854800,"Census Tract 8548,Kane County",17|089|854800,Illinois
2002,2009,1266,743,1400000US17089854900,"Census Tract 8549,Kane County",17|089|854900,Illinois
2003,842,671,171,1400000US17091010100,"Census Tract 101,Kankakee County",17|091|010100,Illinois
2004,823,642,181,1400000US17091010201,"Census Tract 102,01,Kankakee County",17|091|010201,Illinois
2005,1748,1191,557,1400000US17091010203,"Census Tract 102,03,Kankakee County",17|091|010203,Illinois
2006,2148,1463,685,1400000US17091010204,"Census Tract 102,04,Kankakee County",17|091|010204,Illinois
2007,1502,1350,152,1400000US17091010300,"Census Tract 103,Kankakee County",17|091|010300,Illinois
2008,1854,1637,217,1400000US17091010400,"Census Tract 104,Kankakee County",17|091|010400,Illinois
2009,2255,1644,611,1400000US17091010500,"Census Tract 105,Kankakee County",17|091|010500,Illinois
2010,1747,1534,213,1400000US17091010601,"Census Tract 106,01,Kankakee County",17|091|010601,Illinois
2011,2076,1578,498,1400000US17091010602,"Census Tract 106,02,Kankakee County",17|091|010602,Illinois
2012,1591,1060,531,1400000US17091010701,"Census Tract 107,01,Kankakee County",17|091|010701,Illinois
2013,2644,1699,945,1400000US17091010702,"Census Tract 107,02,Kankakee County",17|091|010702,Illinois
2014,1249,833,416,1400000US17091010800,"Census Tract 108,Kankakee County",17|091|010800,Illinois
2015,1747,1367,380,1400000US17091010900,"Census Tract 109,Kankakee County",17|091|010900,Illinois
2016,646,445,201,1400000US17091011000,"Census Tract 110,Kankakee County",17|091|011000,Illinois
2017,819,533,286,1400000US17091011100,"Census Tract 111,Kankakee County",17|091|011100,Illinois
2018,757,660,97,1400000US17091011200,"Census Tract 112,Kankakee County",17|091|011200,Illinois
2019,927,757,170,1400000US17091011300,"Census Tract 113,Kankakee County",17|091|011300,Illinois
2020,736,310,426,1400000US17091011400,"Census Tract 114,Kankakee County",17|091|011400,Illinois
2021,734,255,479,1400000US17091011500,"Census Tract 115,Kankakee County",17|091|011500,Illinois
2022,561,287,274,1400000US17091011600,"Census Tract 116,Kankakee County",17|091|011600,Illinois
2023,1230,489,741,1400000US17091011700,"Census Tract 117,Kankakee County",17|091|011700,Illinois
2024,1068,754,314,1400000US17091011800,"Census Tract 118,Kankakee County",17|091|011800,Illinois
2025,634,363,271,1400000US17091011900,"Census Tract 119,Kankakee County",17|091|011900,Illinois
2026,1532,723,809,1400000US17091012000,"Census Tract 120,Kankakee County",17|091|012000,Illinois
2027,1534,905,629,1400000US17091012100,"Census Tract 121,Kankakee County",17|091|012100,Illinois
2028,1308,1093,215,1400000US17091012200,"Census Tract 122,Kankakee County",17|091|012200,Illinois
2029,1341,306,1035,1400000US17091012300,"Census Tract 123,Kankakee County",17|091|012300,Illinois
2030,1948,1047,901,1400000US17091012400,"Census Tract 124,Kankakee County",17|091|012400,Illinois
2031,677,420,257,1400000US17091012500,"Census Tract 125,Kankakee County",17|091|012500,Illinois
2032,1668,1314,354,1400000US17091012600,"Census Tract 126,Kankakee County",17|091|012600,Illinois
2033,2219,1790,429,1400000US17093890103,"Census Tract 8901,03,Kendall County",17|093|890103,Illinois
2034,2161,1687,474,1400000US17093890104,"Census Tract 8901,04,Kendall County",17|093|890104,Illinois
2035,2652,2386,266,1400000US17093890105,"Census Tract 8901,05,Kendall County",17|093|890105,Illinois
2036,1650,1321,329,1400000US17093890106,"Census Tract 8901,06,Kendall County",17|093|890106,Illinois
2037,1373,1295,78,1400000US17093890107,"Census Tract 8901,07,Kendall County",17|093|890107,Illinois
2038,1726,1669,57,1400000US17093890108,"Census Tract 8901,08,Kendall County",17|093|890108,Illinois
2039,1645,1399,246,1400000US17093890201,"Census Tract 8902,01,Kendall County",17|093|890201,Illinois
2040,1214,1035,179,1400000US17093890202,"Census Tract 8902,02,Kendall County",17|093|890202,Illinois
2041,2377,1711,666,1400000US17093890301,"Census Tract 8903,01,Kendall County",17|093|890301,Illinois
2042,2202,1991,211,1400000US17093890302,"Census Tract 8903,02,Kendall County",17|093|890302,Illinois
2043,2291,1761,530,1400000US17093890401,"Census Tract 8904,01,Kendall County",17|093|890401,Illinois
2044,3238,2816,422,1400000US17093890402,"Census Tract 8904,02,Kendall County",17|093|890402,Illinois
2045,1621,1266,355,1400000US17093890403,"Census Tract 8904,03,Kendall County",17|093|890403,Illinois
2046,2897,2357,540,1400000US17093890404,"Census Tract 8904,04,Kendall County",17|093|890404,Illinois
2047,3098,2300,798,1400000US17093890501,"Census Tract 8905,01,Kendall County",17|093|890501,Illinois
2048,1745,1378,367,1400000US17093890502,"Census Tract 8905,02,Kendall County",17|093|890502,Illinois
2049,1589,1236,353,1400000US17093890601,"Census Tract 8906,01,Kendall County",17|093|890601,Illinois
2050,1811,1728,83,1400000US17093890602,"Census Tract 8906,02,Kendall County",17|093|890602,Illinois
2051,1715,1560,155,1400000US17093890701,"Census Tract 8907,01,Kendall County",17|093|890701,Illinois
2052,1437,1373,64,1400000US17093890702,"Census Tract 8907,02,Kendall County",17|093|890702,Illinois
2053,2564,2304,260,1400000US17093890703,"Census Tract 8907,03,Kendall County",17|093|890703,Illinois
2054,1141,992,149,1400000US17095000100,"Census Tract 1,Knox County",17|095|000100,Illinois
2055,1223,1053,170,1400000US17095000200,"Census Tract 2,Knox County",17|095|000200,Illinois
2056,2094,1551,543,1400000US17095000300,"Census Tract 3,Knox County",17|095|000300,Illinois
2057,2134,1295,839,1400000US17095000400,"Census Tract 4,Knox County",17|095|000400,Illinois
2058,1598,976,622,1400000US17095000500,"Census Tract 5,Knox County",17|095|000500,Illinois
2059,1579,999,580,1400000US17095000600,"Census Tract 6,Knox County",17|095|000600,Illinois
2060,792,584,208,1400000US17095000700,"Census Tract 7,Knox County",17|095|000700,Illinois
2061,953,66,887,1400000US17095000800,"Census Tract 8,Knox County",17|095|000800,Illinois
2062,875,384,491,1400000US17095000900,"Census Tract 9,Knox County",17|095|000900,Illinois
2063,1635,1061,574,1400000US17095001000,"Census Tract 10,Knox County",17|095|001000,Illinois
2064,959,612,347,1400000US17095001100,"Census Tract 11,Knox County",17|095|001100,Illinois
2065,612,404,208,1400000US17095001200,"Census Tract 12,Knox County",17|095|001200,Illinois
2066,1467,1211,256,1400000US17095001300,"Census Tract 13,Knox County",17|095|001300,Illinois
2067,691,580,111,1400000US17095001400,"Census Tract 14,Knox County",17|095|001400,Illinois
2068,1629,1170,459,1400000US17095001500,"Census Tract 15,Knox County",17|095|001500,Illinois
2069,1193,993,200,1400000US17095001600,"Census Tract 16,Knox County",17|095|001600,Illinois
2070,1445,1231,214,1400000US17097860103,"Census Tract 8601,03,Lake County",17|097|860103,Illinois
2071,1359,1050,309,1400000US17097860104,"Census Tract 8601,04,Lake County",17|097|860104,Illinois
2072,1630,1243,387,1400000US17097860105,"Census Tract 8601,05,Lake County",17|097|860105,Illinois
2073,1121,644,477,1400000US17097860106,"Census Tract 8601,06,Lake County",17|097|860106,Illinois
2074,1318,892,426,1400000US17097860200,"Census Tract 8602,Lake County",17|097|860200,Illinois
2075,1147,694,453,1400000US17097860301,"Census Tract 8603,01,Lake County",17|097|860301,Illinois
2076,1017,389,628,1400000US17097860302,"Census Tract 8603,02,Lake County",17|097|860302,Illinois
2077,2335,1356,979,1400000US17097860400,"Census Tract 8604,Lake County",17|097|860400,Illinois
2078,1638,1034,604,1400000US17097860500,"Census Tract 8605,Lake County",17|097|860500,Illinois
2079,2914,2101,813,1400000US17097860600,"Census Tract 8606,Lake County",17|097|860600,Illinois
2080,753,606,147,1400000US17097860805,"Census Tract 8608,05,Lake County",17|097|860805,Illinois
2081,1878,1258,620,1400000US17097860806,"Census Tract 8608,06,Lake County",17|097|860806,Illinois
2082,1825,1393,432,1400000US17097860807,"Census Tract 8608,07,Lake County",17|097|860807,Illinois
2083,1151,1031,120,1400000US17097860808,"Census Tract 8608,08,Lake County",17|097|860808,Illinois
2084,1275,1137,138,1400000US17097860809,"Census Tract 8608,09,Lake County",17|097|860809,Illinois
2085,1821,1462,359,1400000US17097860811,"Census Tract 8608,11,Lake County",17|097|860811,Illinois
2086,1193,884,309,1400000US17097860812,"Census Tract 8608,12,Lake County",17|097|860812,Illinois
2087,1349,1004,345,1400000US17097860813,"Census Tract 8608,13,Lake County",17|097|860813,Illinois
2088,2778,1904,874,1400000US17097860903,"Census Tract 8609,03,Lake County",17|097|860903,Illinois
2089,1732,1387,345,1400000US17097860905,"Census Tract 8609,05,Lake County",17|097|860905,Illinois
2090,3791,3192,599,1400000US17097860906,"Census Tract 8609,06,Lake County",17|097|860906,Illinois
2091,1189,595,594,1400000US17097860907,"Census Tract 8609,07,Lake County",17|097|860907,Illinois
2092,835,556,279,1400000US17097860908,"Census Tract 8609,08,Lake County",17|097|860908,Illinois
2093,1271,1227,44,1400000US17097861007,"Census Tract 8610,07,Lake County",17|097|861007,Illinois
2094,1872,1561,311,1400000US17097861008,"Census Tract 8610,08,Lake County",17|097|861008,Illinois
2095,1757,1439,318,1400000US17097861009,"Census Tract 8610,09,Lake County",17|097|861009,Illinois
2096,1823,1665,158,1400000US17097861010,"Census Tract 8610,10,Lake County",17|097|861010,Illinois
2097,2523,2378,145,1400000US17097861011,"Census Tract 8610,11,Lake County",17|097|861011,Illinois
2098,1916,1251,665,1400000US17097861012,"Census Tract 8610,12,Lake County",17|097|861012,Illinois
2099,1294,847,447,1400000US17097861013,"Census Tract 8610,13,Lake County",17|097|861013,Illinois
2100,1141,1002,139,1400000US17097861014,"Census Tract 8610,14,Lake County",17|097|861014,Illinois
2101,1883,1161,722,1400000US17097861105,"Census Tract 8611,05,Lake County",17|097|861105,Illinois
2102,2746,2176,570,1400000US17097861106,"Census Tract 8611,06,Lake County",17|097|861106,Illinois
2103,1347,1251,96,1400000US17097861107,"Census Tract 8611,07,Lake County",17|097|861107,Illinois
2104,2146,1706,440,1400000US17097861108,"Census Tract 8611,08,Lake County",17|097|861108,Illinois
2105,1810,1439,371,1400000US17097861201,"Census Tract 8612,01,Lake County",17|097|861201,Illinois
2106,1335,1037,298,1400000US17097861202,"Census Tract 8612,02,Lake County",17|097|861202,Illinois
2107,2065,1387,678,1400000US17097861301,"Census Tract 8613,01,Lake County",17|097|861301,Illinois
2108,1330,933,397,1400000US17097861303,"Census Tract 8613,03,Lake County",17|097|861303,Illinois
2109,849,622,227,1400000US17097861304,"Census Tract 8613,04,Lake County",17|097|861304,Illinois
2110,3200,2418,782,1400000US17097861402,"Census Tract 8614,02,Lake County",17|097|861402,Illinois
2111,711,540,171,1400000US17097861403,"Census Tract 8614,03,Lake County",17|097|861403,Illinois
2112,1908,1458,450,1400000US17097861404,"Census Tract 8614,04,Lake County",17|097|861404,Illinois
2113,2987,1432,1555,1400000US17097861504,"Census Tract 8615,04,Lake County",17|097|861504,Illinois
2114,1235,1185,50,1400000US17097861505,"Census Tract 8615,05,Lake County",17|097|861505,Illinois
2115,2215,1143,1072,1400000US17097861506,"Census Tract 8615,06,Lake County",17|097|861506,Illinois
2116,909,699,210,1400000US17097861507,"Census Tract 8615,07,Lake County",17|097|861507,Illinois
2117,1608,934,674,1400000US17097861508,"Census Tract 8615,08,Lake County",17|097|861508,Illinois
2118,1450,797,653,1400000US17097861509,"Census Tract 8615,09,Lake County",17|097|861509,Illinois
2119,1690,1028,662,1400000US17097861510,"Census Tract 8615,10,Lake County",17|097|861510,Illinois
2120,2685,2208,477,1400000US17097861603,"Census Tract 8616,03,Lake County",17|097|861603,Illinois
2121,2058,1837,221,1400000US17097861604,"Census Tract 8616,04,Lake County",17|097|861604,Illinois
2122,1732,1080,652,1400000US17097861607,"Census Tract 8616,07,Lake County",17|097|861607,Illinois
2123,1269,1104,165,1400000US17097861608,"Census Tract 8616,08,Lake County",17|097|861608,Illinois
2124,1646,1240,406,1400000US17097861609,"Census Tract 8616,09,Lake County",17|097|861609,Illinois
2125,1276,1081,195,1400000US17097861610,"Census Tract 8616,10,Lake County",17|097|861610,Illinois
2126,1231,1190,41,1400000US17097861611,"Census Tract 8616,11,Lake County",17|097|861611,Illinois
2127,555,453,102,1400000US17097861701,"Census Tract 8617,01,Lake County",17|097|861701,Illinois
2128,1387,1176,211,1400000US17097861702,"Census Tract 8617,02,Lake County",17|097|861702,Illinois
2129,2448,1207,1241,1400000US17097861803,"Census Tract 8618,03,Lake County",17|097|861803,Illinois
2130,1261,727,534,1400000US17097861804,"Census Tract 8618,04,Lake County",17|097|861804,Illinois
2131,1036,909,127,1400000US17097861901,"Census Tract 8619,01,Lake County",17|097|861901,Illinois
2132,2918,976,1942,1400000US17097861902,"Census Tract 8619,02,Lake County",17|097|861902,Illinois
2133,2014,987,1027,1400000US17097862000,"Census Tract 8620,Lake County",17|097|862000,Illinois
2134,1780,930,850,1400000US17097862100,"Census Tract 8621,Lake County",17|097|862100,Illinois
2135,1222,470,752,1400000US17097862200,"Census Tract 8622,Lake County",17|097|862200,Illinois
2136,1001,241,760,1400000US17097862300,"Census Tract 8623,Lake County",17|097|862300,Illinois
2137,1263,405,858,1400000US17097862401,"Census Tract 8624,01,Lake County",17|097|862401,Illinois
2138,1041,501,540,1400000US17097862402,"Census Tract 8624,02,Lake County",17|097|862402,Illinois
2139,1125,784,341,1400000US17097862501,"Census Tract 8625,01,Lake County",17|097|862501,Illinois
2140,536,405,131,1400000US17097862502,"Census Tract 8625,02,Lake County",17|097|862502,Illinois
2141,2553,1129,1424,1400000US17097862603,"Census Tract 8626,03,Lake County",17|097|862603,Illinois
2142,1411,797,614,1400000US17097862604,"Census Tract 8626,04,Lake County",17|097|862604,Illinois
2143,1572,497,1075,1400000US17097862605,"Census Tract 8626,05,Lake County",17|097|862605,Illinois
2144,1126,475,651,1400000US17097862700,"Census Tract 8627,Lake County",17|097|862700,Illinois
2145,715,156,559,1400000US17097862800,"Census Tract 8628,Lake County",17|097|862800,Illinois
2146,1161,471,690,1400000US17097862901,"Census Tract 8629,01,Lake County",17|097|862901,Illinois
2147,903,319,584,1400000US17097862902,"Census Tract 8629,02,Lake County",17|097|862902,Illinois
2148,25,0,25,1400000US17097863003,"Census Tract 8630,03,Lake County",17|097|863003,Illinois
2149,1961,18,1943,1400000US17097863004,"Census Tract 8630,04,Lake County",17|097|863004,Illinois
2150,0,0,0,1400000US17097863005,"Census Tract 8630,05,Lake County",17|097|863005,Illinois
2151,0,0,0,1400000US17097863006,"Census Tract 8630,06,Lake County",17|097|863006,Illinois
2152,925,423,502,1400000US17097863100,"Census Tract 8631,Lake County",17|097|863100,Illinois
2153,1038,764,274,1400000US17097863201,"Census Tract 8632,01,Lake County",17|097|863201,Illinois
2154,2067,1740,327,1400000US17097863202,"Census Tract 8632,02,Lake County",17|097|863202,Illinois
2155,921,799,122,1400000US17097863300,"Census Tract 8633,Lake County",17|097|863300,Illinois
2156,1323,1010,313,1400000US17097863400,"Census Tract 8634,Lake County",17|097|863400,Illinois
2157,2086,1706,380,1400000US17097863500,"Census Tract 8635,Lake County",17|097|863500,Illinois
2158,1180,1104,76,1400000US17097863601,"Census Tract 8636,01,Lake County",17|097|863601,Illinois
2159,1132,1034,98,1400000US17097863603,"Census Tract 8636,03,Lake County",17|097|863603,Illinois
2160,1079,754,325,1400000US17097863604,"Census Tract 8636,04,Lake County",17|097|863604,Illinois
2161,1952,1548,404,1400000US17097863701,"Census Tract 8637,01,Lake County",17|097|863701,Illinois
2162,1950,1031,919,1400000US17097863702,"Census Tract 8637,02,Lake County",17|097|863702,Illinois
2163,1763,1395,368,1400000US17097863801,"Census Tract 8638,01,Lake County",17|097|863801,Illinois
2164,2828,1765,1063,1400000US17097863902,"Census Tract 8639,02,Lake County",17|097|863902,Illinois
2165,1579,1278,301,1400000US17097863903,"Census Tract 8639,03,Lake County",17|097|863903,Illinois
2166,2112,2036,76,1400000US17097863904,"Census Tract 8639,04,Lake County",17|097|863904,Illinois
2167,2165,1214,951,1400000US17097864001,"Census Tract 8640,01,Lake County",17|097|864001,Illinois
2168,1528,855,673,1400000US17097864002,"Census Tract 8640,02,Lake County",17|097|864002,Illinois
2169,2467,2317,150,1400000US17097864105,"Census Tract 8641,05,Lake County",17|097|864105,Illinois
2170,1384,1275,109,1400000US17097864106,"Census Tract 8641,06,Lake County",17|097|864106,Illinois
2171,1875,1624,251,1400000US17097864107,"Census Tract 8641,07,Lake County",17|097|864107,Illinois
2172,2038,1735,303,1400000US17097864108,"Census Tract 8641,08,Lake County",17|097|864108,Illinois
2173,1927,1879,48,1400000US17097864109,"Census Tract 8641,09,Lake County",17|097|864109,Illinois
2174,2798,2508,290,1400000US17097864110,"Census Tract 8641,10,Lake County",17|097|864110,Illinois
2175,1546,1328,218,1400000US17097864203,"Census Tract 8642,03,Lake County",17|097|864203,Illinois
2176,1608,1259,349,1400000US17097864204,"Census Tract 8642,04,Lake County",17|097|864204,Illinois
2177,1347,1000,347,1400000US17097864206,"Census Tract 8642,06,Lake County",17|097|864206,Illinois
2178,2351,1991,360,1400000US17097864207,"Census Tract 8642,07,Lake County",17|097|864207,Illinois
2179,1779,1273,506,1400000US17097864208,"Census Tract 8642,08,Lake County",17|097|864208,Illinois
2180,1550,1474,76,1400000US17097864303,"Census Tract 8643,03,Lake County",17|097|864303,Illinois
2181,1879,1792,87,1400000US17097864305,"Census Tract 8643,05,Lake County",17|097|864305,Illinois
2182,716,703,13,1400000US17097864306,"Census Tract 8643,06,Lake County",17|097|864306,Illinois
2183,841,621,220,1400000US17097864307,"Census Tract 8643,07,Lake County",17|097|864307,Illinois
2184,1699,1299,400,1400000US17097864308,"Census Tract 8643,08,Lake County",17|097|864308,Illinois
2185,2580,2503,77,1400000US17097864402,"Census Tract 8644,02,Lake County",17|097|864402,Illinois
2186,1828,1615,213,1400000US17097864403,"Census Tract 8644,03,Lake County",17|097|864403,Illinois
2187,1961,1942,19,1400000US17097864407,"Census Tract 8644,07,Lake County",17|097|864407,Illinois
2188,2486,1732,754,1400000US17097864408,"Census Tract 8644,08,Lake County",17|097|864408,Illinois
2189,1712,1175,537,1400000US17097864409,"Census Tract 8644,09,Lake County",17|097|864409,Illinois
2190,1696,1654,42,1400000US17097864410,"Census Tract 8644,10,Lake County",17|097|864410,Illinois
2191,1656,1556,100,1400000US17097864411,"Census Tract 8644,11,Lake County",17|097|864411,Illinois
2192,1340,1301,39,1400000US17097864412,"Census Tract 8644,12,Lake County",17|097|864412,Illinois
2193,1992,851,1141,1400000US17097864510,"Census Tract 8645,10,Lake County",17|097|864510,Illinois
2194,2358,1482,876,1400000US17097864511,"Census Tract 8645,11,Lake County",17|097|864511,Illinois
2195,1402,1202,200,1400000US17097864512,"Census Tract 8645,12,Lake County",17|097|864512,Illinois
2196,2140,1636,504,1400000US17097864513,"Census Tract 8645,13,Lake County",17|097|864513,Illinois
2197,1041,815,226,1400000US17097864514,"Census Tract 8645,14,Lake County",17|097|864514,Illinois
2198,957,911,46,1400000US17097864515,"Census Tract 8645,15,Lake County",17|097|864515,Illinois
2199,1549,1425,124,1400000US17097864516,"Census Tract 8645,16,Lake County",17|097|864516,Illinois
2200,1086,971,115,1400000US17097864517,"Census Tract 8645,17,Lake County",17|097|864517,Illinois
2201,1824,1675,149,1400000US17097864518,"Census Tract 8645,18,Lake County",17|097|864518,Illinois
2202,1802,1554,248,1400000US17097864519,"Census Tract 8645,19,Lake County",17|097|864519,Illinois
2203,1680,1438,242,1400000US17097864520,"Census Tract 8645,20,Lake County",17|097|864520,Illinois
2204,1448,1029,419,1400000US17097864521,"Census Tract 8645,21,Lake County",17|097|864521,Illinois
2205,1605,1565,40,1400000US17097864522,"Census Tract 8645,22,Lake County",17|097|864522,Illinois
2206,1580,883,697,1400000US17097864523,"Census Tract 8645,23,Lake County",17|097|864523,Illinois
2207,1544,598,946,1400000US17097864524,"Census Tract 8645,24,Lake County",17|097|864524,Illinois
2208,1215,1133,82,1400000US17097864601,"Census Tract 8646,01,Lake County",17|097|864601,Illinois
2209,1261,1245,16,1400000US17097864602,"Census Tract 8646,02,Lake County",17|097|864602,Illinois
2210,985,904,81,1400000US17097864700,"Census Tract 8647,Lake County",17|097|864700,Illinois
2211,1707,1427,280,1400000US17097864801,"Census Tract 8648,01,Lake County",17|097|864801,Illinois
2212,1074,778,296,1400000US17097864802,"Census Tract 8648,02,Lake County",17|097|864802,Illinois
2213,1589,1458,131,1400000US17097864901,"Census Tract 8649,01,Lake County",17|097|864901,Illinois
2214,1812,1675,137,1400000US17097864903,"Census Tract 8649,03,Lake County",17|097|864903,Illinois
2215,1232,1002,230,1400000US17097864904,"Census Tract 8649,04,Lake County",17|097|864904,Illinois
2216,376,338,38,1400000US17097865000,"Census Tract 8650,Lake County",17|097|865000,Illinois
2217,2108,921,1187,1400000US17097865200,"Census Tract 8652,Lake County",17|097|865200,Illinois
2218,1183,1126,57,1400000US17097865300,"Census Tract 8653,Lake County",17|097|865300,Illinois
2219,2199,1425,774,1400000US17097865400,"Census Tract 8654,Lake County",17|097|865400,Illinois
2220,1078,793,285,1400000US17097865501,"Census Tract 8655,01,Lake County",17|097|865501,Illinois
2221,830,645,185,1400000US17097865502,"Census Tract 8655,02,Lake County",17|097|865502,Illinois
2222,1420,1348,72,1400000US17097865600,"Census Tract 8656,Lake County",17|097|865600,Illinois
2223,2365,2168,197,1400000US17097865700,"Census Tract 8657,Lake County",17|097|865700,Illinois
2224,1317,1115,202,1400000US17097865801,"Census Tract 8658,01,Lake County",17|097|865801,Illinois
2225,1000,959,41,1400000US17097865802,"Census Tract 8658,02,Lake County",17|097|865802,Illinois
2226,2395,2225,170,1400000US17097866000,"Census Tract 8660,Lake County",17|097|866000,Illinois
2227,1129,435,694,1400000US17097866100,"Census Tract 8661,Lake County",17|097|866100,Illinois
2228,2330,1843,487,1400000US17097866200,"Census Tract 8662,Lake County",17|097|866200,Illinois
2229,0,0,0,1400000US17097990000,"Census Tract 9900,Lake County",17|097|990000,Illinois
2230,2325,2064,261,1400000US17099961701,"Census Tract 9617,01,LaSalle County",17|099|961701,Illinois
2231,1263,980,283,1400000US17099961702,"Census Tract 9617,02,LaSalle County",17|099|961702,Illinois
2232,1558,1085,473,1400000US17099961800,"Census Tract 9618,LaSalle County",17|099|961800,Illinois
2233,1829,1251,578,1400000US17099961900,"Census Tract 9619,LaSalle County",17|099|961900,Illinois
2234,1323,1029,294,1400000US17099962000,"Census Tract 9620,LaSalle County",17|099|962000,Illinois
2235,2075,1540,535,1400000US17099962100,"Census Tract 9621,LaSalle County",17|099|962100,Illinois
2236,1927,1638,289,1400000US17099962200,"Census Tract 9622,LaSalle County",17|099|962200,Illinois
2237,2291,1853,438,1400000US17099962300,"Census Tract 9623,LaSalle County",17|099|962300,Illinois
2238,1493,932,561,1400000US17099962400,"Census Tract 9624,LaSalle County",17|099|962400,Illinois
2239,809,647,162,1400000US17099962500,"Census Tract 9625,LaSalle County",17|099|962500,Illinois
2240,2157,1377,780,1400000US17099962600,"Census Tract 9626,LaSalle County",17|099|962600,Illinois
2241,1100,516,584,1400000US17099962700,"Census Tract 9627,LaSalle County",17|099|962700,Illinois
2242,1512,1016,496,1400000US17099962800,"Census Tract 9628,LaSalle County",17|099|962800,Illinois
2243,1371,978,393,1400000US17099962900,"Census Tract 9629,LaSalle County",17|099|962900,Illinois
2244,2116,1480,636,1400000US17099963000,"Census Tract 9630,LaSalle County",17|099|963000,Illinois
2245,1442,1134,308,1400000US17099963100,"Census Tract 9631,LaSalle County",17|099|963100,Illinois
2246,1128,791,337,1400000US17099963200,"Census Tract 9632,LaSalle County",17|099|963200,Illinois
2247,1144,522,622,1400000US17099963300,"Census Tract 9633,LaSalle County",17|099|963300,Illinois
2248,1670,1279,391,1400000US17099963400,"Census Tract 9634,LaSalle County",17|099|963400,Illinois
2249,1945,1369,576,1400000US17099963500,"Census Tract 9635,LaSalle County",17|099|963500,Illinois
2250,1295,1012,283,1400000US17099963600,"Census Tract 9636,LaSalle County",17|099|963600,Illinois
2251,1980,1595,385,1400000US17099963700,"Census Tract 9637,LaSalle County",17|099|963700,Illinois
2252,1817,1258,559,1400000US17099963800,"Census Tract 9638,LaSalle County",17|099|963800,Illinois
2253,2452,1385,1067,1400000US17099963900,"Census Tract 9639,LaSalle County",17|099|963900,Illinois
2254,1002,917,85,1400000US17099964000,"Census Tract 9640,LaSalle County",17|099|964000,Illinois
2255,1554,1276,278,1400000US17099964100,"Census Tract 9641,LaSalle County",17|099|964100,Illinois
2256,1079,841,238,1400000US17099964200,"Census Tract 9642,LaSalle County",17|099|964200,Illinois
2257,1216,729,487,1400000US17099964300,"Census Tract 9643,LaSalle County",17|099|964300,Illinois
2258,1168,1094,74,1400000US17101880700,"Census Tract 8807,Lawrence County",17|101|880700,Illinois
2259,1308,1089,219,1400000US17101880800,"Census Tract 8808,Lawrence County",17|101|880800,Illinois
2260,951,674,277,1400000US17101880900,"Census Tract 8809,Lawrence County",17|101|880900,Illinois
2261,755,434,321,1400000US17101881000,"Census Tract 8810,Lawrence County",17|101|881000,Illinois
2262,1267,807,460,1400000US17101881100,"Census Tract 8811,Lawrence County",17|101|881100,Illinois
2263,1014,781,233,1400000US17103000100,"Census Tract 1,Lee County",17|103|000100,Illinois
2264,1196,974,222,1400000US17103000200,"Census Tract 2,Lee County",17|103|000200,Illinois
2265,1748,1137,611,1400000US17103000300,"Census Tract 3,Lee County",17|103|000300,Illinois
2266,2274,1651,623,1400000US17103000400,"Census Tract 4,Lee County",17|103|000400,Illinois
2267,2241,1660,581,1400000US17103000500,"Census Tract 5,Lee County",17|103|000500,Illinois
2268,1628,950,678,1400000US17103000600,"Census Tract 6,Lee County",17|103|000600,Illinois
2269,665,559,106,1400000US17103000700,"Census Tract 7,Lee County",17|103|000700,Illinois
2270,1441,1004,437,1400000US17103000800,"Census Tract 8,Lee County",17|103|000800,Illinois
2271,1301,972,329,1400000US17103000900,"Census Tract 9,Lee County",17|103|000900,Illinois
2272,1513,1014,499,1400000US17105960100,"Census Tract 9601,Livingston County",17|105|960100,Illinois
2273,1274,1008,266,1400000US17105960200,"Census Tract 9602,Livingston County",17|105|960200,Illinois
2274,1348,1096,252,1400000US17105960300,"Census Tract 9603,Livingston County",17|105|960300,Illinois
2275,1246,1027,219,1400000US17105960400,"Census Tract 9604,Livingston County",17|105|960400,Illinois
2276,1232,667,565,1400000US17105960500,"Census Tract 9605,Livingston County",17|105|960500,Illinois
2277,1876,1009,867,1400000US17105960600,"Census Tract 9606,Livingston County",17|105|960600,Illinois
2278,1687,1329,358,1400000US17105960700,"Census Tract 9607,Livingston County",17|105|960700,Illinois
2279,2329,1702,627,1400000US17105960800,"Census Tract 9608,Livingston County",17|105|960800,Illinois
2280,911,789,122,1400000US17105960900,"Census Tract 9609,Livingston County",17|105|960900,Illinois
2281,1015,780,235,1400000US17105961000,"Census Tract 9610,Livingston County",17|105|961000,Illinois
2282,1500,1246,254,1400000US17107952900,"Census Tract 9529,Logan County",17|107|952900,Illinois
2283,987,737,250,1400000US17107953000,"Census Tract 9530,Logan County",17|107|953000,Illinois
2284,1592,916,676,1400000US17107953100,"Census Tract 9531,Logan County",17|107|953100,Illinois
2285,1408,1029,379,1400000US17107953200,"Census Tract 9532,Logan County",17|107|953200,Illinois
2286,1501,872,629,1400000US17107953300,"Census Tract 9533,Logan County",17|107|953300,Illinois
2287,1615,1030,585,1400000US17107953400,"Census Tract 9534,Logan County",17|107|953400,Illinois
2288,1026,895,131,1400000US17107953500,"Census Tract 9535,Logan County",17|107|953500,Illinois
2289,1374,1111,263,1400000US17107953600,"Census Tract 9536,Logan County",17|107|953600,Illinois
2290,1357,1046,311,1400000US17109010100,"Census Tract 101,McDonough County",17|109|010100,Illinois
2291,752,614,138,1400000US17109010200,"Census Tract 102,McDonough County",17|109|010200,Illinois
2292,881,703,178,1400000US17109010300,"Census Tract 103,McDonough County",17|109|010300,Illinois
2293,403,57,346,1400000US17109010401,"Census Tract 104,01,McDonough County",17|109|010401,Illinois
2294,1666,546,1120,1400000US17109010402,"Census Tract 104,02,McDonough County",17|109|010402,Illinois
2295,973,525,448,1400000US17109010600,"Census Tract 106,McDonough County",17|109|010600,Illinois
2296,1806,1230,576,1400000US17109010700,"Census Tract 107,McDonough County",17|109|010700,Illinois
2297,1148,524,624,1400000US17109010900,"Census Tract 109,McDonough County",17|109|010900,Illinois
2298,953,763,190,1400000US17109011000,"Census Tract 110,McDonough County",17|109|011000,Illinois
2299,1290,1020,270,1400000US17109011100,"Census Tract 111,McDonough County",17|109|011100,Illinois
2300,18,0,18,1400000US17109980000,"Census Tract 9800,McDonough County",17|109|980000,Illinois
2301,931,678,253,1400000US17111870103,"Census Tract 8701,03,McHenry County",17|111|870103,Illinois
2302,2123,1503,620,1400000US17111870104,"Census Tract 8701,04,McHenry County",17|111|870104,Illinois
2303,1250,1250,0,1400000US17111870105,"Census Tract 8701,05,McHenry County",17|111|870105,Illinois
2304,929,911,18,1400000US17111870106,"Census Tract 8701,06,McHenry County",17|111|870106,Illinois
2305,2104,1713,391,1400000US17111870200,"Census Tract 8702,McHenry County",17|111|870200,Illinois
2306,1719,1004,715,1400000US17111870301,"Census Tract 8703,01,McHenry County",17|111|870301,Illinois
2307,1392,884,508,1400000US17111870302,"Census Tract 8703,02,McHenry County",17|111|870302,Illinois
2308,2181,1553,628,1400000US17111870402,"Census Tract 8704,02,McHenry County",17|111|870402,Illinois
2309,1542,1426,116,1400000US17111870403,"Census Tract 8704,03,McHenry County",17|111|870403,Illinois
2310,1424,1288,136,1400000US17111870404,"Census Tract 8704,04,McHenry County",17|111|870404,Illinois
2311,1626,1448,178,1400000US17111870501,"Census Tract 8705,01,McHenry County",17|111|870501,Illinois
2312,1934,1428,506,1400000US17111870502,"Census Tract 8705,02,McHenry County",17|111|870502,Illinois
2313,1771,1360,411,1400000US17111870603,"Census Tract 8706,03,McHenry County",17|111|870603,Illinois
2314,2344,1770,574,1400000US17111870604,"Census Tract 8706,04,McHenry County",17|111|870604,Illinois
2315,2533,2355,178,1400000US17111870605,"Census Tract 8706,05,McHenry County",17|111|870605,Illinois
2316,1608,992,616,1400000US17111870606,"Census Tract 8706,06,McHenry County",17|111|870606,Illinois
2317,3119,2675,444,1400000US17111870702,"Census Tract 8707,02,McHenry County",17|111|870702,Illinois
2318,1899,1835,64,1400000US17111870703,"Census Tract 8707,03,McHenry County",17|111|870703,Illinois
2319,1360,1250,110,1400000US17111870704,"Census Tract 8707,04,McHenry County",17|111|870704,Illinois
2320,1912,1403,509,1400000US17111870807,"Census Tract 8708,07,McHenry County",17|111|870807,Illinois
2321,1318,1140,178,1400000US17111870808,"Census Tract 8708,08,McHenry County",17|111|870808,Illinois
2322,2852,2058,794,1400000US17111870809,"Census Tract 8708,09,McHenry County",17|111|870809,Illinois
2323,1630,1511,119,1400000US17111870810,"Census Tract 8708,10,McHenry County",17|111|870810,Illinois
2324,1819,1523,296,1400000US17111870811,"Census Tract 8708,11,McHenry County",17|111|870811,Illinois
2325,1705,1351,354,1400000US17111870812,"Census Tract 8708,12,McHenry County",17|111|870812,Illinois
2326,2021,1383,638,1400000US17111870813,"Census Tract 8708,13,McHenry County",17|111|870813,Illinois
2327,1260,1240,20,1400000US17111870814,"Census Tract 8708,14,McHenry County",17|111|870814,Illinois
2328,1372,736,636,1400000US17111870903,"Census Tract 8709,03,McHenry County",17|111|870903,Illinois
2329,1877,1411,466,1400000US17111870904,"Census Tract 8709,04,McHenry County",17|111|870904,Illinois
2330,2053,1120,933,1400000US17111870905,"Census Tract 8709,05,McHenry County",17|111|870905,Illinois
2331,1776,1209,567,1400000US17111870906,"Census Tract 8709,06,McHenry County",17|111|870906,Illinois
2332,1172,1069,103,1400000US17111870907,"Census Tract 8709,07,McHenry County",17|111|870907,Illinois
2333,1590,1208,382,1400000US17111871003,"Census Tract 8710,03,McHenry County",17|111|871003,Illinois
2334,2325,1581,744,1400000US17111871004,"Census Tract 8710,04,McHenry County",17|111|871004,Illinois
2335,1756,1617,139,1400000US17111871105,"Census Tract 8711,05,McHenry County",17|111|871105,Illinois
2336,1715,1633,82,1400000US17111871107,"Census Tract 8711,07,McHenry County",17|111|871107,Illinois
2337,1767,1634,133,1400000US17111871108,"Census Tract 8711,08,McHenry County",17|111|871108,Illinois
2338,1572,1341,231,1400000US17111871109,"Census Tract 8711,09,McHenry County",17|111|871109,Illinois
2339,1238,1061,177,1400000US17111871110,"Census Tract 8711,10,McHenry County",17|111|871110,Illinois
2340,1669,1653,16,1400000US17111871111,"Census Tract 8711,11,McHenry County",17|111|871111,Illinois
2341,1906,1781,125,1400000US17111871112,"Census Tract 8711,12,McHenry County",17|111|871112,Illinois
2342,1167,1144,23,1400000US17111871113,"Census Tract 8711,13,McHenry County",17|111|871113,Illinois
2343,1111,1048,63,1400000US17111871114,"Census Tract 8711,14,McHenry County",17|111|871114,Illinois
2344,1262,775,487,1400000US17111871115,"Census Tract 8711,15,McHenry County",17|111|871115,Illinois
2345,2703,2353,350,1400000US17111871201,"Census Tract 8712,01,McHenry County",17|111|871201,Illinois
2346,1958,1259,699,1400000US17111871202,"Census Tract 8712,02,McHenry County",17|111|871202,Illinois
2347,1557,1332,225,1400000US17111871205,"Census Tract 8712,05,McHenry County",17|111|871205,Illinois
2348,2604,2114,490,1400000US17111871206,"Census Tract 8712,06,McHenry County",17|111|871206,Illinois
2349,1712,1354,358,1400000US17111871207,"Census Tract 8712,07,McHenry County",17|111|871207,Illinois
2350,1338,1238,100,1400000US17111871208,"Census Tract 8712,08,McHenry County",17|111|871208,Illinois
2351,1517,654,863,1400000US17111871209,"Census Tract 8712,09,McHenry County",17|111|871209,Illinois
2352,1820,1275,545,1400000US17111871301,"Census Tract 8713,01,McHenry County",17|111|871301,Illinois
2353,1281,1180,101,1400000US17111871304,"Census Tract 8713,04,McHenry County",17|111|871304,Illinois
2354,1939,1770,169,1400000US17111871305,"Census Tract 8713,05,McHenry County",17|111|871305,Illinois
2355,1791,1535,256,1400000US17111871307,"Census Tract 8713,07,McHenry County",17|111|871307,Illinois
2356,1680,1557,123,1400000US17111871310,"Census Tract 8713,10,McHenry County",17|111|871310,Illinois
2357,1916,1471,445,1400000US17111871311,"Census Tract 8713,11,McHenry County",17|111|871311,Illinois
2358,2068,2043,25,1400000US17111871312,"Census Tract 8713,12,McHenry County",17|111|871312,Illinois
2359,770,592,178,1400000US17111871313,"Census Tract 8713,13,McHenry County",17|111|871313,Illinois
2360,2268,1893,375,1400000US17111871402,"Census Tract 8714,02,McHenry County",17|111|871402,Illinois
2361,1632,1269,363,1400000US17111871404,"Census Tract 8714,04,McHenry County",17|111|871404,Illinois
2362,3326,3276,50,1400000US17111871501,"Census Tract 8715,01,McHenry County",17|111|871501,Illinois
2363,2837,2465,372,1400000US17111871502,"Census Tract 8715,02,McHenry County",17|111|871502,Illinois
2364,2095,1661,434,1400000US17111871600,"Census Tract 8716,McHenry County",17|111|871600,Illinois
2365,1767,1346,421,1400000US17113000105,"Census Tract 1,05,McLean County",17|113|000105,Illinois
2366,1440,348,1092,1400000US17113000106,"Census Tract 1,06,McLean County",17|113|000106,Illinois
2367,1610,997,613,1400000US17113000107,"Census Tract 1,07,McLean County",17|113|000107,Illinois
2368,2338,605,1733,1400000US17113000108,"Census Tract 1,08,McLean County",17|113|000108,Illinois
2369,2001,1737,264,1400000US17113000109,"Census Tract 1,09,McLean County",17|113|000109,Illinois
2370,264,0,264,1400000US17113000200,"Census Tract 2,McLean County",17|113|000200,Illinois
2371,1743,722,1021,1400000US17113000301,"Census Tract 3,01,McLean County",17|113|000301,Illinois
2372,2578,1458,1120,1400000US17113000302,"Census Tract 3,02,McLean County",17|113|000302,Illinois
2373,1035,314,721,1400000US17113000400,"Census Tract 4,McLean County",17|113|000400,Illinois
2374,1344,477,867,1400000US17113000501,"Census Tract 5,01,McLean County",17|113|000501,Illinois
2375,1123,1027,96,1400000US17113000502,"Census Tract 5,02,McLean County",17|113|000502,Illinois
2376,2208,1234,974,1400000US17113000504,"Census Tract 5,04,McLean County",17|113|000504,Illinois
2377,1141,1097,44,1400000US17113000506,"Census Tract 5,06,McLean County",17|113|000506,Illinois
2378,945,807,138,1400000US17113000507,"Census Tract 5,07,McLean County",17|113|000507,Illinois
2379,1344,797,547,1400000US17113001103,"Census Tract 11,03,McLean County",17|113|001103,Illinois
2380,2135,1176,959,1400000US17113001105,"Census Tract 11,05,McLean County",17|113|001105,Illinois
2381,1384,583,801,1400000US17113001106,"Census Tract 11,06,McLean County",17|113|001106,Illinois
2382,1481,1111,370,1400000US17113001107,"Census Tract 11,07,McLean County",17|113|001107,Illinois
2383,1934,1201,733,1400000US17113001108,"Census Tract 11,08,McLean County",17|113|001108,Illinois
2384,1205,595,610,1400000US17113001200,"Census Tract 12,McLean County",17|113|001200,Illinois
2385,835,531,304,1400000US17113001301,"Census Tract 13,01,McLean County",17|113|001301,Illinois
2386,518,74,444,1400000US17113001302,"Census Tract 13,02,McLean County",17|113|001302,Illinois
2387,824,394,430,1400000US17113001303,"Census Tract 13,03,McLean County",17|113|001303,Illinois
2388,1252,920,332,1400000US17113001402,"Census Tract 14,02,McLean County",17|113|001402,Illinois
2389,1751,1287,464,1400000US17113001403,"Census Tract 14,03,McLean County",17|113|001403,Illinois
2390,1580,1367,213,1400000US17113001404,"Census Tract 14,04,McLean County",17|113|001404,Illinois
2391,898,382,516,1400000US17113001500,"Census Tract 15,McLean County",17|113|001500,Illinois
2392,1469,354,1115,1400000US17113001600,"Census Tract 16,McLean County",17|113|001600,Illinois
2393,1058,423,635,1400000US17113001700,"Census Tract 17,McLean County",17|113|001700,Illinois
2394,1425,1170,255,1400000US17113001800,"Census Tract 18,McLean County",17|113|001800,Illinois
2395,2344,1649,695,1400000US17113002101,"Census Tract 21,01,McLean County",17|113|002101,Illinois
2396,693,649,44,1400000US17113002102,"Census Tract 21,02,McLean County",17|113|002102,Illinois
2397,2741,2400,341,1400000US17113005102,"Census Tract 51,02,McLean County",17|113|005102,Illinois
2398,1566,1502,64,1400000US17113005103,"Census Tract 51,03,McLean County",17|113|005103,Illinois
2399,1989,1054,935,1400000US17113005104,"Census Tract 51,04,McLean County",17|113|005104,Illinois
2400,398,385,13,1400000US17113005201,"Census Tract 52,01,McLean County",17|113|005201,Illinois
2401,1131,989,142,1400000US17113005202,"Census Tract 52,02,McLean County",17|113|005202,Illinois
2402,2234,2005,229,1400000US17113005401,"Census Tract 54,01,McLean County",17|113|005401,Illinois
2403,1317,1110,207,1400000US17113005402,"Census Tract 54,02,McLean County",17|113|005402,Illinois
2404,920,737,183,1400000US17113005501,"Census Tract 55,01,McLean County",17|113|005501,Illinois
2405,961,835,126,1400000US17113005502,"Census Tract 55,02,McLean County",17|113|005502,Illinois
2406,660,514,146,1400000US17113005601,"Census Tract 56,01,McLean County",17|113|005601,Illinois
2407,851,748,103,1400000US17113005602,"Census Tract 56,02,McLean County",17|113|005602,Illinois
2408,1896,1492,404,1400000US17113005700,"Census Tract 57,McLean County",17|113|005700,Illinois
2409,2136,1202,934,1400000US17113005800,"Census Tract 58,McLean County",17|113|005800,Illinois
2410,2084,1114,970,1400000US17113005900,"Census Tract 59,McLean County",17|113|005900,Illinois
2411,1349,1075,274,1400000US17113006000,"Census Tract 60,McLean County",17|113|006000,Illinois
2412,785,324,461,1400000US17115000200,"Census Tract 2,Macon County",17|115|000200,Illinois
2413,1317,618,699,1400000US17115000300,"Census Tract 3,Macon County",17|115|000300,Illinois
2414,387,307,80,1400000US17115000400,"Census Tract 4,Macon County",17|115|000400,Illinois
2415,414,88,326,1400000US17115000501,"Census Tract 5,01,Macon County",17|115|000501,Illinois
2416,992,303,689,1400000US17115000502,"Census Tract 5,02,Macon County",17|115|000502,Illinois
2417,663,257,406,1400000US17115000600,"Census Tract 6,Macon County",17|115|000600,Illinois
2418,642,258,384,1400000US17115000900,"Census Tract 9,Macon County",17|115|000900,Illinois
2419,534,295,239,1400000US17115001000,"Census Tract 10,Macon County",17|115|001000,Illinois
2420,1638,1267,371,1400000US17115001100,"Census Tract 11,Macon County",17|115|001100,Illinois
2421,1137,768,369,1400000US17115001200,"Census Tract 12,Macon County",17|115|001200,Illinois
2422,1023,926,97,1400000US17115001300,"Census Tract 13,Macon County",17|115|001300,Illinois
2423,1142,593,549,1400000US17115001400,"Census Tract 14,Macon County",17|115|001400,Illinois
2424,1818,1501,317,1400000US17115001500,"Census Tract 15,Macon County",17|115|001500,Illinois
2425,631,437,194,1400000US17115001600,"Census Tract 16,Macon County",17|115|001600,Illinois
2426,770,586,184,1400000US17115001700,"Census Tract 17,Macon County",17|115|001700,Illinois
2427,915,788,127,1400000US17115001801,"Census Tract 18,01,Macon County",17|115|001801,Illinois
2428,866,612,254,1400000US17115001802,"Census Tract 18,02,Macon County",17|115|001802,Illinois
2429,1204,531,673,1400000US17115001900,"Census Tract 19,Macon County",17|115|001900,Illinois
2430,674,89,585,1400000US17115002001,"Census Tract 20,01,Macon County",17|115|002001,Illinois
2431,1015,563,452,1400000US17115002002,"Census Tract 20,02,Macon County",17|115|002002,Illinois
2432,594,375,219,1400000US17115002100,"Census Tract 21,Macon County",17|115|002100,Illinois
2433,2050,1763,287,1400000US17115002200,"Census Tract 22,Macon County",17|115|002200,Illinois
2434,1095,1027,68,1400000US17115002300,"Census Tract 23,Macon County",17|115|002300,Illinois
2435,1064,987,77,1400000US17115002401,"Census Tract 24,01,Macon County",17|115|002401,Illinois
2436,2175,1781,394,1400000US17115002402,"Census Tract 24,02,Macon County",17|115|002402,Illinois
2437,2627,2173,454,1400000US17115002500,"Census Tract 25,Macon County",17|115|002500,Illinois
2438,1780,1666,114,1400000US17115002601,"Census Tract 26,01,Macon County",17|115|002601,Illinois
2439,706,606,100,1400000US17115002602,"Census Tract 26,02,Macon County",17|115|002602,Illinois
2440,917,754,163,1400000US17115002700,"Census Tract 27,Macon County",17|115|002700,Illinois
2441,1537,1322,215,1400000US17115002800,"Census Tract 28,Macon County",17|115|002800,Illinois
2442,1605,1435,170,1400000US17115002901,"Census Tract 29,01,Macon County",17|115|002901,Illinois
2443,2037,1503,534,1400000US17115002902,"Census Tract 29,02,Macon County",17|115|002902,Illinois
2444,2429,1647,782,1400000US17115002904,"Census Tract 29,04,Macon County",17|115|002904,Illinois
2445,595,218,377,1400000US17115002905,"Census Tract 29,05,Macon County",17|115|002905,Illinois
2446,1538,422,1116,1400000US17115002906,"Census Tract 29,06,Macon County",17|115|002906,Illinois
2447,1326,1050,276,1400000US17115003000,"Census Tract 30,Macon County",17|115|003000,Illinois
2448,622,71,551,1400000US17115003100,"Census Tract 31,Macon County",17|115|003100,Illinois
2449,1278,886,392,1400000US17117956000,"Census Tract 9560,Macoupin County",17|117|956000,Illinois
2450,1137,866,271,1400000US17117956100,"Census Tract 9561,Macoupin County",17|117|956100,Illinois
2451,1025,808,217,1400000US17117956200,"Census Tract 9562,Macoupin County",17|117|956200,Illinois
2452,1054,960,94,1400000US17117956300,"Census Tract 9563,Macoupin County",17|117|956300,Illinois
2453,2052,1257,795,1400000US17117956400,"Census Tract 9564,Macoupin County",17|117|956400,Illinois
2454,935,859,76,1400000US17117956500,"Census Tract 9565,Macoupin County",17|117|956500,Illinois
2455,1698,1411,287,1400000US17117956600,"Census Tract 9566,Macoupin County",17|117|956600,Illinois
2456,1408,1095,313,1400000US17117956700,"Census Tract 9567,Macoupin County",17|117|956700,Illinois
2457,971,743,228,1400000US17117956800,"Census Tract 9568,Macoupin County",17|117|956800,Illinois
2458,1458,1034,424,1400000US17117956900,"Census Tract 9569,Macoupin County",17|117|956900,Illinois
2459,1427,1117,310,1400000US17117957000,"Census Tract 9570,Macoupin County",17|117|957000,Illinois
2460,1192,934,258,1400000US17117957100,"Census Tract 9571,Macoupin County",17|117|957100,Illinois
2461,2014,1492,522,1400000US17117957200,"Census Tract 9572,Macoupin County",17|117|957200,Illinois
2462,1147,890,257,1400000US17119400101,"Census Tract 4001,01,Madison County",17|119|400101,Illinois
2463,1938,941,997,1400000US17119400102,"Census Tract 4001,02,Madison County",17|119|400102,Illinois
2464,1486,949,537,1400000US17119400200,"Census Tract 4002,Madison County",17|119|400200,Illinois
2465,1057,503,554,1400000US17119400600,"Census Tract 4006,Madison County",17|119|400600,Illinois
2466,770,375,395,1400000US17119400700,"Census Tract 4007,Madison County",17|119|400700,Illinois
2467,742,619,123,1400000US17119400801,"Census Tract 4008,01,Madison County",17|119|400801,Illinois
2468,2672,2058,614,1400000US17119400802,"Census Tract 4008,02,Madison County",17|119|400802,Illinois
2469,1809,1145,664,1400000US17119400903,"Census Tract 4009,03,Madison County",17|119|400903,Illinois
2470,1375,1197,178,1400000US17119400904,"Census Tract 4009,04,Madison County",17|119|400904,Illinois
2471,2014,1278,736,1400000US17119400951,"Census Tract 4009,51,Madison County",17|119|400951,Illinois
2472,1269,862,407,1400000US17119400952,"Census Tract 4009,52,Madison County",17|119|400952,Illinois
2473,1033,697,336,1400000US17119401000,"Census Tract 4010,Madison County",17|119|401000,Illinois
2474,1153,729,424,1400000US17119401101,"Census Tract 4011,01,Madison County",17|119|401101,Illinois
2475,1483,1193,290,1400000US17119401102,"Census Tract 4011,02,Madison County",17|119|401102,Illinois
2476,861,611,250,1400000US17119401200,"Census Tract 4012,Madison County",17|119|401200,Illinois
2477,2207,1239,968,1400000US17119401300,"Census Tract 4013,Madison County",17|119|401300,Illinois
2478,1290,960,330,1400000US17119401400,"Census Tract 4014,Madison County",17|119|401400,Illinois
2479,1199,737,462,1400000US17119401500,"Census Tract 4015,Madison County",17|119|401500,Illinois
2480,866,498,368,1400000US17119401701,"Census Tract 4017,01,Madison County",17|119|401701,Illinois
2481,2236,1945,291,1400000US17119401721,"Census Tract 4017,21,Madison County",17|119|401721,Illinois
2482,1298,995,303,1400000US17119401722,"Census Tract 4017,22,Madison County",17|119|401722,Illinois
2483,2393,2085,308,1400000US17119401800,"Census Tract 4018,Madison County",17|119|401800,Illinois
2484,741,641,100,1400000US17119401901,"Census Tract 4019,01,Madison County",17|119|401901,Illinois
2485,1978,1531,447,1400000US17119401905,"Census Tract 4019,05,Madison County",17|119|401905,Illinois
2486,2031,1280,751,1400000US17119402000,"Census Tract 4020,Madison County",17|119|402000,Illinois
2487,1142,722,420,1400000US17119402100,"Census Tract 4021,Madison County",17|119|402100,Illinois
2488,1401,894,507,1400000US17119402200,"Census Tract 4022,Madison County",17|119|402200,Illinois
2489,778,476,302,1400000US17119402300,"Census Tract 4023,Madison County",17|119|402300,Illinois
2490,813,388,425,1400000US17119402400,"Census Tract 4024,Madison County",17|119|402400,Illinois
2491,688,396,292,1400000US17119402500,"Census Tract 4025,Madison County",17|119|402500,Illinois
2492,1055,484,571,1400000US17119402600,"Census Tract 4026,Madison County",17|119|402600,Illinois
2493,3137,2351,786,1400000US17119402701,"Census Tract 4027,01,Madison County",17|119|402701,Illinois
2494,3286,2693,593,1400000US17119402721,"Census Tract 4027,21,Madison County",17|119|402721,Illinois
2495,1194,1068,126,1400000US17119402722,"Census Tract 4027,22,Madison County",17|119|402722,Illinois
2496,1641,1554,87,1400000US17119402801,"Census Tract 4028,01,Madison County",17|119|402801,Illinois
2497,1141,953,188,1400000US17119402803,"Census Tract 4028,03,Madison County",17|119|402803,Illinois
2498,938,891,47,1400000US17119402804,"Census Tract 4028,04,Madison County",17|119|402804,Illinois
2499,2081,1793,288,1400000US17119402805,"Census Tract 4028,05,Madison County",17|119|402805,Illinois
2500,2047,1217,830,1400000US17119402900,"Census Tract 4029,Madison County",17|119|402900,Illinois
2501,2304,1282,1022,1400000US17119403001,"Census Tract 4030,01,Madison County",17|119|403001,Illinois
2502,2506,2023,483,1400000US17119403002,"Census Tract 4030,02,Madison County",17|119|403002,Illinois
2503,1538,849,689,1400000US17119403101,"Census Tract 4031,01,Madison County",17|119|403101,Illinois
2504,3829,2820,1009,1400000US17119403121,"Census Tract 4031,21,Madison County",17|119|403121,Illinois
2505,2268,1521,747,1400000US17119403122,"Census Tract 4031,22,Madison County",17|119|403122,Illinois
2506,2082,1448,634,1400000US17119403200,"Census Tract 4032,Madison County",17|119|403200,Illinois
2507,1176,585,591,1400000US17119403300,"Census Tract 4033,Madison County",17|119|403300,Illinois
2508,1739,875,864,1400000US17119403401,"Census Tract 4034,01,Madison County",17|119|403401,Illinois
2509,1333,874,459,1400000US17119403403,"Census Tract 4034,03,Madison County",17|119|403403,Illinois
2510,1395,908,487,1400000US17119403404,"Census Tract 4034,04,Madison County",17|119|403404,Illinois
2511,2308,1933,375,1400000US17119403502,"Census Tract 4035,02,Madison County",17|119|403502,Illinois
2512,3234,2397,837,1400000US17119403531,"Census Tract 4035,31,Madison County",17|119|403531,Illinois
2513,1886,1757,129,1400000US17119403532,"Census Tract 4035,32,Madison County",17|119|403532,Illinois
2514,4318,3384,934,1400000US17119403533,"Census Tract 4035,33,Madison County",17|119|403533,Illinois
2515,1845,1482,363,1400000US17119403534,"Census Tract 4035,34,Madison County",17|119|403534,Illinois
2516,1730,1174,556,1400000US17119403601,"Census Tract 4036,01,Madison County",17|119|403601,Illinois
2517,764,666,98,1400000US17119403603,"Census Tract 4036,03,Madison County",17|119|403603,Illinois
2518,2888,1925,963,1400000US17119403604,"Census Tract 4036,04,Madison County",17|119|403604,Illinois
2519,2298,2130,168,1400000US17119403701,"Census Tract 4037,01,Madison County",17|119|403701,Illinois
2520,2048,1966,82,1400000US17119403702,"Census Tract 4037,02,Madison County",17|119|403702,Illinois
2521,2060,1848,212,1400000US17119403801,"Census Tract 4038,01,Madison County",17|119|403801,Illinois
2522,1811,1541,270,1400000US17119403802,"Census Tract 4038,02,Madison County",17|119|403802,Illinois
2523,1064,544,520,1400000US17119404000,"Census Tract 4040,Madison County",17|119|404000,Illinois
2524,1423,1128,295,1400000US17119404100,"Census Tract 4041,Madison County",17|119|404100,Illinois
2525,1432,1246,186,1400000US17121951600,"Census Tract 9516,Marion County",17|121|951600,Illinois
2526,1063,981,82,1400000US17121951700,"Census Tract 9517,Marion County",17|121|951700,Illinois
2527,926,743,183,1400000US17121951800,"Census Tract 9518,Marion County",17|121|951800,Illinois
2528,1127,828,299,1400000US17121951900,"Census Tract 9519,Marion County",17|121|951900,Illinois
2529,1803,1309,494,1400000US17121952000,"Census Tract 9520,Marion County",17|121|952000,Illinois
2530,1339,721,618,1400000US17121952100,"Census Tract 9521,Marion County",17|121|952100,Illinois
2531,1544,1386,158,1400000US17121952200,"Census Tract 9522,Marion County",17|121|952200,Illinois
2532,1292,1110,182,1400000US17121952300,"Census Tract 9523,Marion County",17|121|952300,Illinois
2533,1686,1331,355,1400000US17121952400,"Census Tract 9524,Marion County",17|121|952400,Illinois
2534,977,615,362,1400000US17121952500,"Census Tract 9525,Marion County",17|121|952500,Illinois
2535,805,442,363,1400000US17121952600,"Census Tract 9526,Marion County",17|121|952600,Illinois
2536,1300,713,587,1400000US17121952700,"Census Tract 9527,Marion County",17|121|952700,Illinois
2537,1099,872,227,1400000US17123961100,"Census Tract 9611,Marshall County",17|123|961100,Illinois
2538,1068,797,271,1400000US17123961200,"Census Tract 9612,Marshall County",17|123|961200,Illinois
2539,910,751,159,1400000US17123961300,"Census Tract 9613,Marshall County",17|123|961300,Illinois
2540,1033,871,162,1400000US17123961400,"Census Tract 9614,Marshall County",17|123|961400,Illinois
2541,782,631,151,1400000US17123961500,"Census Tract 9615,Marshall County",17|123|961500,Illinois
2542,1148,923,225,1400000US17125956300,"Census Tract 9563,Mason County",17|125|956300,Illinois
2543,788,666,122,1400000US17125956400,"Census Tract 9564,Mason County",17|125|956400,Illinois
2544,1463,1014,449,1400000US17125956500,"Census Tract 9565,Mason County",17|125|956500,Illinois
2545,685,594,91,1400000US17125956600,"Census Tract 9566,Mason County",17|125|956600,Illinois
2546,689,600,89,1400000US17125956700,"Census Tract 9567,Mason County",17|125|956700,Illinois
2547,1017,784,233,1400000US17125956800,"Census Tract 9568,Mason County",17|125|956800,Illinois
2548,1648,1469,179,1400000US17127970100,"Census Tract 9701,Massac County",17|127|970100,Illinois
2549,1536,1091,445,1400000US17127970200,"Census Tract 9702,Massac County",17|127|970200,Illinois
2550,1276,1129,147,1400000US17127970300,"Census Tract 9703,Massac County",17|127|970300,Illinois
2551,1006,574,432,1400000US17127970400,"Census Tract 9704,Massac County",17|127|970400,Illinois
2552,2351,1913,438,1400000US17129010100,"Census Tract 101,Menard County",17|129|010100,Illinois
2553,1751,1245,506,1400000US17129010200,"Census Tract 102,Menard County",17|129|010200,Illinois
2554,1012,893,119,1400000US17129010300,"Census Tract 103,Menard County",17|129|010300,Illinois
2555,1743,1508,235,1400000US17131040100,"Census Tract 401,Mercer County",17|131|040100,Illinois
2556,1361,1106,255,1400000US17131040200,"Census Tract 402,Mercer County",17|131|040200,Illinois
2557,1609,948,661,1400000US17131040300,"Census Tract 403,Mercer County",17|131|040300,Illinois
2558,1626,1397,229,1400000US17131040400,"Census Tract 404,Mercer County",17|131|040400,Illinois
2559,1658,1479,179,1400000US17133600102,"Census Tract 6001,02,Monroe County",17|133|600102,Illinois
2560,1472,1096,376,1400000US17133600103,"Census Tract 6001,03,Monroe County",17|133|600103,Illinois
2561,1853,1675,178,1400000US17133600104,"Census Tract 6001,04,Monroe County",17|133|600104,Illinois
2562,3082,2328,754,1400000US17133600401,"Census Tract 6004,01,Monroe County",17|133|600401,Illinois
2563,1698,1492,206,1400000US17133600402,"Census Tract 6004,02,Monroe County",17|133|600402,Illinois
2564,2505,2180,325,1400000US17133600501,"Census Tract 6005,01,Monroe County",17|133|600501,Illinois
2565,1211,1054,157,1400000US17133600502,"Census Tract 6005,02,Monroe County",17|133|600502,Illinois
2566,1325,1063,262,1400000US17135957300,"Census Tract 9573,Montgomery County",17|135|957300,Illinois
2567,865,637,228,1400000US17135957400,"Census Tract 9574,Montgomery County",17|135|957400,Illinois
2568,1112,851,261,1400000US17135957500,"Census Tract 9575,Montgomery County",17|135|957500,Illinois
2569,1409,1263,146,1400000US17135957600,"Census Tract 9576,Montgomery County",17|135|957600,Illinois
2570,1255,955,300,1400000US17135957700,"Census Tract 9577,Montgomery County",17|135|957700,Illinois
2571,1587,915,672,1400000US17135957800,"Census Tract 9578,Montgomery County",17|135|957800,Illinois
2572,1979,1412,567,1400000US17135957900,"Census Tract 9579,Montgomery County",17|135|957900,Illinois
2573,1613,1309,304,1400000US17135958000,"Census Tract 9580,Montgomery County",17|135|958000,Illinois
2574,1003,823,180,1400000US17137951400,"Census Tract 9514,Morgan County",17|137|951400,Illinois
2575,1011,887,124,1400000US17137951500,"Census Tract 9515,Morgan County",17|137|951500,Illinois
2576,1217,674,543,1400000US17137951600,"Census Tract 9516,Morgan County",17|137|951600,Illinois
2577,921,512,409,1400000US17137951700,"Census Tract 9517,Morgan County",17|137|951700,Illinois
2578,1501,910,591,1400000US17137951800,"Census Tract 9518,Morgan County",17|137|951800,Illinois
2579,1905,1573,332,1400000US17137951900,"Census Tract 9519,Morgan County",17|137|951900,Illinois
2580,1490,728,762,1400000US17137952000,"Census Tract 9520,Morgan County",17|137|952000,Illinois
2581,1645,1047,598,1400000US17137952100,"Census Tract 9521,Morgan County",17|137|952100,Illinois
2582,1248,1056,192,1400000US17137952200,"Census Tract 9522,Morgan County",17|137|952200,Illinois
2583,1246,1009,237,1400000US17137952300,"Census Tract 9523,Morgan County",17|137|952300,Illinois
2584,1754,1463,291,1400000US17139976900,"Census Tract 9769,Moultrie County",17|139|976900,Illinois
2585,1080,765,315,1400000US17139977000,"Census Tract 9770,Moultrie County",17|139|977000,Illinois
2586,1236,1012,224,1400000US17139977100,"Census Tract 9771,Moultrie County",17|139|977100,Illinois
2587,1683,1282,401,1400000US17139977200,"Census Tract 9772,Moultrie County",17|139|977200,Illinois
2588,1628,1432,196,1400000US17141960700,"Census Tract 9607,Ogle County",17|141|960700,Illinois
2589,1363,1081,282,1400000US17141960800,"Census Tract 9608,Ogle County",17|141|960800,Illinois
2590,2119,1410,709,1400000US17141960900,"Census Tract 9609,Ogle County",17|141|960900,Illinois
2591,1128,966,162,1400000US17141961001,"Census Tract 9610,01,Ogle County",17|141|961001,Illinois
2592,1172,1020,152,1400000US17141961002,"Census Tract 9610,02,Ogle County",17|141|961002,Illinois
2593,1780,786,994,1400000US17141961100,"Census Tract 9611,Ogle County",17|141|961100,Illinois
2594,2653,2007,646,1400000US17141961200,"Census Tract 9612,Ogle County",17|141|961200,Illinois
2595,871,753,118,1400000US17141961301,"Census Tract 9613,01,Ogle County",17|141|961301,Illinois
2596,1042,956,86,1400000US17141961302,"Census Tract 9613,02,Ogle County",17|141|961302,Illinois
2597,1883,1222,661,1400000US17141961400,"Census Tract 9614,Ogle County",17|141|961400,Illinois
2598,1937,1357,580,1400000US17141961500,"Census Tract 9615,Ogle County",17|141|961500,Illinois
2599,1387,662,725,1400000US17141961600,"Census Tract 9616,Ogle County",17|141|961600,Illinois
2600,1808,1298,510,1400000US17141961700,"Census Tract 9617,Ogle County",17|141|961700,Illinois
2601,663,255,408,1400000US17143000200,"Census Tract 2,Peoria County",17|143|000200,Illinois
2602,527,265,262,1400000US17143000300,"Census Tract 3,Peoria County",17|143|000300,Illinois
2603,1164,510,654,1400000US17143000600,"Census Tract 6,Peoria County",17|143|000600,Illinois
2604,1271,72,1199,1400000US17143000900,"Census Tract 9,Peoria County",17|143|000900,Illinois
2605,632,119,513,1400000US17143001200,"Census Tract 12,Peoria County",17|143|001200,Illinois
2606,789,159,630,1400000US17143001300,"Census Tract 13,Peoria County",17|143|001300,Illinois
2607,689,313,376,1400000US17143001500,"Census Tract 15,Peoria County",17|143|001500,Illinois
2608,1545,472,1073,1400000US17143001600,"Census Tract 16,Peoria County",17|143|001600,Illinois
2609,1215,512,703,1400000US17143001800,"Census Tract 18,Peoria County",17|143|001800,Illinois
2610,521,246,275,1400000US17143001900,"Census Tract 19,Peoria County",17|143|001900,Illinois
2611,476,364,112,1400000US17143002000,"Census Tract 20,Peoria County",17|143|002000,Illinois
2612,1715,1115,600,1400000US17143002100,"Census Tract 21,Peoria County",17|143|002100,Illinois
2613,1661,972,689,1400000US17143002200,"Census Tract 22,Peoria County",17|143|002200,Illinois
2614,2247,1490,757,1400000US17143002300,"Census Tract 23,Peoria County",17|143|002300,Illinois
2615,2157,1618,539,1400000US17143002400,"Census Tract 24,Peoria County",17|143|002400,Illinois
2616,1194,476,718,1400000US17143002500,"Census Tract 25,Peoria County",17|143|002500,Illinois
2617,771,528,243,1400000US17143002600,"Census Tract 26,Peoria County",17|143|002600,Illinois
2618,1512,1066,446,1400000US17143002701,"Census Tract 27,01,Peoria County",17|143|002701,Illinois
2619,1687,979,708,1400000US17143002702,"Census Tract 27,02,Peoria County",17|143|002702,Illinois
2620,1653,833,820,1400000US17143002800,"Census Tract 28,Peoria County",17|143|002800,Illinois
2621,1737,1196,541,1400000US17143002900,"Census Tract 29,Peoria County",17|143|002900,Illinois
2622,2069,1487,582,1400000US17143003000,"Census Tract 30,Peoria County",17|143|003000,Illinois
2623,2145,1662,483,1400000US17143003101,"Census Tract 31,01,Peoria County",17|143|003101,Illinois
2624,1379,619,760,1400000US17143003103,"Census Tract 31,03,Peoria County",17|143|003103,Illinois
2625,1482,988,494,1400000US17143003104,"Census Tract 31,04,Peoria County",17|143|003104,Illinois
2626,2216,1149,1067,1400000US17143003200,"Census Tract 32,Peoria County",17|143|003200,Illinois
2627,1399,1007,392,1400000US17143003300,"Census Tract 33,Peoria County",17|143|003300,Illinois
2628,1713,1447,266,1400000US17143003402,"Census Tract 34,02,Peoria County",17|143|003402,Illinois
2629,1349,1088,261,1400000US17143003403,"Census Tract 34,03,Peoria County",17|143|003403,Illinois
2630,3440,2127,1313,1400000US17143003404,"Census Tract 34,04,Peoria County",17|143|003404,Illinois
2631,985,777,208,1400000US17143003601,"Census Tract 36,01,Peoria County",17|143|003601,Illinois
2632,2600,2030,570,1400000US17143003602,"Census Tract 36,02,Peoria County",17|143|003602,Illinois
2633,1256,1165,91,1400000US17143003700,"Census Tract 37,Peoria County",17|143|003700,Illinois
2634,1243,1052,191,1400000US17143003800,"Census Tract 38,Peoria County",17|143|003800,Illinois
2635,3113,2507,606,1400000US17143003900,"Census Tract 39,Peoria County",17|143|003900,Illinois
2636,1701,1454,247,1400000US17143004000,"Census Tract 40,Peoria County",17|143|004000,Illinois
2637,2717,1899,818,1400000US17143004101,"Census Tract 41,01,Peoria County",17|143|004101,Illinois
2638,1314,768,546,1400000US17143004102,"Census Tract 41,02,Peoria County",17|143|004102,Illinois
2639,1812,1034,778,1400000US17143004200,"Census Tract 42,Peoria County",17|143|004200,Illinois
2640,990,632,358,1400000US17143004300,"Census Tract 43,Peoria County",17|143|004300,Illinois
2641,1879,1270,609,1400000US17143004400,"Census Tract 44,Peoria County",17|143|004400,Illinois
2642,1826,1414,412,1400000US17143004500,"Census Tract 45,Peoria County",17|143|004500,Illinois
2643,2083,1806,277,1400000US17143004600,"Census Tract 46,Peoria County",17|143|004600,Illinois
2644,1864,1576,288,1400000US17143004801,"Census Tract 48,01,Peoria County",17|143|004801,Illinois
2645,1676,1233,443,1400000US17143004802,"Census Tract 48,02,Peoria County",17|143|004802,Illinois
2646,1361,1206,155,1400000US17143004901,"Census Tract 49,01,Peoria County",17|143|004901,Illinois
2647,1893,1671,222,1400000US17143004902,"Census Tract 49,02,Peoria County",17|143|004902,Illinois
2648,945,546,399,1400000US17143005000,"Census Tract 50,Peoria County",17|143|005000,Illinois
2649,1076,296,780,1400000US17143005100,"Census Tract 51,Peoria County",17|143|005100,Illinois
2650,1167,1036,131,1400000US17145030100,"Census Tract 301,Perry County",17|145|030100,Illinois
2651,2444,1817,627,1400000US17145030200,"Census Tract 302,Perry County",17|145|030200,Illinois
2652,768,656,112,1400000US17145030300,"Census Tract 303,Perry County",17|145|030300,Illinois
2653,1020,612,408,1400000US17145030400,"Census Tract 304,Perry County",17|145|030400,Illinois
2654,985,756,229,1400000US17145030500,"Census Tract 305,Perry County",17|145|030500,Illinois
2655,1724,1191,533,1400000US17145030600,"Census Tract 306,Perry County",17|145|030600,Illinois
2656,1589,1419,170,1400000US17147954500,"Census Tract 9545,Piatt County",17|147|954500,Illinois
2657,2767,2218,549,1400000US17147954600,"Census Tract 9546,Piatt County",17|147|954600,Illinois
2658,1240,1033,207,1400000US17147954700,"Census Tract 9547,Piatt County",17|147|954700,Illinois
2659,1090,862,228,1400000US17147954800,"Census Tract 9548,Piatt County",17|147|954800,Illinois
2660,1297,955,342,1400000US17149952400,"Census Tract 9524,Pike County",17|149|952400,Illinois
2661,952,740,212,1400000US17149952500,"Census Tract 9525,Pike County",17|149|952500,Illinois
2662,977,831,146,1400000US17149952600,"Census Tract 9526,Pike County",17|149|952600,Illinois
2663,1823,1364,459,1400000US17149952700,"Census Tract 9527,Pike County",17|149|952700,Illinois
2664,707,632,75,1400000US17149952800,"Census Tract 9528,Pike County",17|149|952800,Illinois
2665,713,638,75,1400000US17151971200,"Census Tract 9712,Pope County",17|151|971200,Illinois
2666,659,508,151,1400000US17151971300,"Census Tract 9713,Pope County",17|151|971300,Illinois
2667,920,700,220,1400000US17153971000,"Census Tract 9710,Pulaski County",17|153|971000,Illinois
2668,937,703,234,1400000US17153971100,"Census Tract 9711,Pulaski County",17|153|971100,Illinois
2669,1159,889,270,1400000US17155954500,"Census Tract 9545,Putnam County",17|155|954500,Illinois
2670,1139,975,164,1400000US17155954600,"Census Tract 9546,Putnam County",17|155|954600,Illinois
2671,826,697,129,1400000US17157950500,"Census Tract 9505,Randolph County",17|157|950500,Illinois
2672,1802,1092,710,1400000US17157950600,"Census Tract 9506,Randolph County",17|157|950600,Illinois
2673,939,733,206,1400000US17157950700,"Census Tract 9507,Randolph County",17|157|950700,Illinois
2674,1893,1350,543,1400000US17157950800,"Census Tract 9508,Randolph County",17|157|950800,Illinois
2675,1316,1139,177,1400000US17157950900,"Census Tract 9509,Randolph County",17|157|950900,Illinois
2676,922,805,117,1400000US17157951000,"Census Tract 9510,Randolph County",17|157|951000,Illinois
2677,1462,1010,452,1400000US17157951100,"Census Tract 9511,Randolph County",17|157|951100,Illinois
2678,795,629,166,1400000US17157951201,"Census Tract 9512,01,Randolph County",17|157|951201,Illinois
2679,224,173,51,1400000US17157951202,"Census Tract 9512,02,Randolph County",17|157|951202,Illinois
2680,1359,944,415,1400000US17157951300,"Census Tract 9513,Randolph County",17|157|951300,Illinois
2681,1599,1306,293,1400000US17159977900,"Census Tract 9779,Richland County",17|159|977900,Illinois
2682,783,450,333,1400000US17159978000,"Census Tract 9780,Richland County",17|159|978000,Illinois
2683,1595,1048,547,1400000US17159978100,"Census Tract 9781,Richland County",17|159|978100,Illinois
2684,1157,806,351,1400000US17159978200,"Census Tract 9782,Richland County",17|159|978200,Illinois
2685,1247,1091,156,1400000US17159978300,"Census Tract 9783,Richland County",17|159|978300,Illinois
2686,972,800,172,1400000US17161020101,"Census Tract 201,01,Rock Island County",17|161|020101,Illinois
2687,1474,1266,208,1400000US17161020102,"Census Tract 201,02,Rock Island County",17|161|020102,Illinois
2688,410,338,72,1400000US17161020103,"Census Tract 201,03,Rock Island County",17|161|020103,Illinois
2689,1517,958,559,1400000US17161020200,"Census Tract 202,Rock Island County",17|161|020200,Illinois
2690,2187,1063,1124,1400000US17161020301,"Census Tract 203,01,Rock Island County",17|161|020301,Illinois
2691,1189,620,569,1400000US17161020302,"Census Tract 203,02,Rock Island County",17|161|020302,Illinois
2692,2228,1736,492,1400000US17161020400,"Census Tract 204,Rock Island County",17|161|020400,Illinois
2693,842,567,275,1400000US17161020600,"Census Tract 206,Rock Island County",17|161|020600,Illinois
2694,639,306,333,1400000US17161020700,"Census Tract 207,Rock Island County",17|161|020700,Illinois
2695,1876,1598,278,1400000US17161020800,"Census Tract 208,Rock Island County",17|161|020800,Illinois
2696,2135,1647,488,1400000US17161020900,"Census Tract 209,Rock Island County",17|161|020900,Illinois
2697,1779,812,967,1400000US17161021000,"Census Tract 210,Rock Island County",17|161|021000,Illinois
2698,1670,1189,481,1400000US17161021100,"Census Tract 211,Rock Island County",17|161|021100,Illinois
2699,1947,962,985,1400000US17161021200,"Census Tract 212,Rock Island County",17|161|021200,Illinois
2700,2267,1293,974,1400000US17161021300,"Census Tract 213,Rock Island County",17|161|021300,Illinois
2701,554,364,190,1400000US17161021400,"Census Tract 214,Rock Island County",17|161|021400,Illinois
2702,2071,1831,240,1400000US17161021500,"Census Tract 215,Rock Island County",17|161|021500,Illinois
2703,1014,612,402,1400000US17161021600,"Census Tract 216,Rock Island County",17|161|021600,Illinois
2704,1372,777,595,1400000US17161021700,"Census Tract 217,Rock Island County",17|161|021700,Illinois
2705,1996,1593,403,1400000US17161021800,"Census Tract 218,Rock Island County",17|161|021800,Illinois
2706,789,358,431,1400000US17161021900,"Census Tract 219,Rock Island County",17|161|021900,Illinois
2707,1665,1479,186,1400000US17161022000,"Census Tract 220,Rock Island County",17|161|022000,Illinois
2708,1267,939,328,1400000US17161022100,"Census Tract 221,Rock Island County",17|161|022100,Illinois
2709,1308,736,572,1400000US17161022200,"Census Tract 222,Rock Island County",17|161|022200,Illinois
2710,911,288,623,1400000US17161022300,"Census Tract 223,Rock Island County",17|161|022300,Illinois
2711,1073,267,806,1400000US17161022600,"Census Tract 226,Rock Island County",17|161|022600,Illinois
2712,1376,716,660,1400000US17161022800,"Census Tract 228,Rock Island County",17|161|022800,Illinois
2713,1270,1027,243,1400000US17161022900,"Census Tract 229,Rock Island County",17|161|022900,Illinois
2714,1687,1410,277,1400000US17161023000,"Census Tract 230,Rock Island County",17|161|023000,Illinois
2715,1131,1032,99,1400000US17161023100,"Census Tract 231,Rock Island County",17|161|023100,Illinois
2716,2377,1764,613,1400000US17161023200,"Census Tract 232,Rock Island County",17|161|023200,Illinois
2717,1315,598,717,1400000US17161023300,"Census Tract 233,Rock Island County",17|161|023300,Illinois
2718,654,325,329,1400000US17161023500,"Census Tract 235,Rock Island County",17|161|023500,Illinois
2719,589,344,245,1400000US17161023600,"Census Tract 236,Rock Island County",17|161|023600,Illinois
2720,943,586,357,1400000US17161023700,"Census Tract 237,Rock Island County",17|161|023700,Illinois
2721,1787,1572,215,1400000US17161024000,"Census Tract 240,Rock Island County",17|161|024000,Illinois
2722,1554,1472,82,1400000US17161024101,"Census Tract 241,01,Rock Island County",17|161|024101,Illinois
2723,2138,1721,417,1400000US17161024102,"Census Tract 241,02,Rock Island County",17|161|024102,Illinois
2724,1554,1366,188,1400000US17161024103,"Census Tract 241,03,Rock Island County",17|161|024103,Illinois
2725,2074,1550,524,1400000US17161024200,"Census Tract 242,Rock Island County",17|161|024200,Illinois
2726,1355,718,637,1400000US17161024300,"Census Tract 243,Rock Island County",17|161|024300,Illinois
2727,978,292,686,1400000US17161024400,"Census Tract 244,Rock Island County",17|161|024400,Illinois
2728,760,235,525,1400000US17161024500,"Census Tract 245,Rock Island County",17|161|024500,Illinois
2729,842,463,379,1400000US17163500400,"Census Tract 5004,St, Clair County",17|163|500400,Illinois
2730,638,313,325,1400000US17163500500,"Census Tract 5005,St, Clair County",17|163|500500,Illinois
2731,1145,307,838,1400000US17163500900,"Census Tract 5009,St, Clair County",17|163|500900,Illinois
2732,444,288,156,1400000US17163501100,"Census Tract 5011,St, Clair County",17|163|501100,Illinois
2733,768,630,138,1400000US17163501200,"Census Tract 5012,St, Clair County",17|163|501200,Illinois
2734,1038,867,171,1400000US17163501300,"Census Tract 5013,St, Clair County",17|163|501300,Illinois
2735,734,591,143,1400000US17163501400,"Census Tract 5014,St, Clair County",17|163|501400,Illinois
2736,718,570,148,1400000US17163501501,"Census Tract 5015,01,St, Clair County",17|163|501501,Illinois
2737,1144,875,269,1400000US17163501502,"Census Tract 5015,02,St, Clair County",17|163|501502,Illinois
2738,1845,992,853,1400000US17163501602,"Census Tract 5016,02,St, Clair County",17|163|501602,Illinois
2739,2218,846,1372,1400000US17163501604,"Census Tract 5016,04,St, Clair County",17|163|501604,Illinois
2740,1366,1207,159,1400000US17163501605,"Census Tract 5016,05,St, Clair County",17|163|501605,Illinois
2741,1512,824,688,1400000US17163501606,"Census Tract 5016,06,St, Clair County",17|163|501606,Illinois
2742,935,560,375,1400000US17163501607,"Census Tract 5016,07,St, Clair County",17|163|501607,Illinois
2743,1231,634,597,1400000US17163501700,"Census Tract 5017,St, Clair County",17|163|501700,Illinois
2744,1308,1011,297,1400000US17163501801,"Census Tract 5018,01,St, Clair County",17|163|501801,Illinois
2745,990,478,512,1400000US17163501802,"Census Tract 5018,02,St, Clair County",17|163|501802,Illinois
2746,1387,843,544,1400000US17163501900,"Census Tract 5019,St, Clair County",17|163|501900,Illinois
2747,778,477,301,1400000US17163502100,"Census Tract 5021,St, Clair County",17|163|502100,Illinois
2748,562,459,103,1400000US17163502200,"Census Tract 5022,St, Clair County",17|163|502200,Illinois
2749,1856,772,1084,1400000US17163502300,"Census Tract 5023,St, Clair County",17|163|502300,Illinois
2750,431,207,224,1400000US17163502401,"Census Tract 5024,01,St, Clair County",17|163|502401,Illinois
2751,1247,861,386,1400000US17163502404,"Census Tract 5024,04,St, Clair County",17|163|502404,Illinois
2752,276,147,129,1400000US17163502500,"Census Tract 5025,St, Clair County",17|163|502500,Illinois
2753,1498,768,730,1400000US17163502602,"Census Tract 5026,02,St, Clair County",17|163|502602,Illinois
2754,1077,541,536,1400000US17163502603,"Census Tract 5026,03,St, Clair County",17|163|502603,Illinois
2755,363,193,170,1400000US17163502700,"Census Tract 5027,St, Clair County",17|163|502700,Illinois
2756,1046,230,816,1400000US17163502800,"Census Tract 5028,St, Clair County",17|163|502800,Illinois
2757,815,488,327,1400000US17163502900,"Census Tract 5029,St, Clair County",17|163|502900,Illinois
2758,860,668,192,1400000US17163503101,"Census Tract 5031,01,St, Clair County",17|163|503101,Illinois
2759,1868,1216,652,1400000US17163503102,"Census Tract 5031,02,St, Clair County",17|163|503102,Illinois
2760,2269,1638,631,1400000US17163503202,"Census Tract 5032,02,St, Clair County",17|163|503202,Illinois
2761,2651,2327,324,1400000US17163503203,"Census Tract 5032,03,St, Clair County",17|163|503203,Illinois
2762,1803,1200,603,1400000US17163503211,"Census Tract 5032,11,St, Clair County",17|163|503211,Illinois
2763,1628,911,717,1400000US17163503301,"Census Tract 5033,01,St, Clair County",17|163|503301,Illinois
2764,2607,2054,553,1400000US17163503304,"Census Tract 5033,04,St, Clair County",17|163|503304,Illinois
2765,2603,2199,404,1400000US17163503322,"Census Tract 5033,22,St, Clair County",17|163|503322,Illinois
2766,2506,1997,509,1400000US17163503323,"Census Tract 5033,23,St, Clair County",17|163|503323,Illinois
2767,2611,1488,1123,1400000US17163503324,"Census Tract 5033,24,St, Clair County",17|163|503324,Illinois
2768,2278,1552,726,1400000US17163503332,"Census Tract 5033,32,St, Clair County",17|163|503332,Illinois
2769,2533,1673,860,1400000US17163503334,"Census Tract 5033,34,St, Clair County",17|163|503334,Illinois
2770,2675,2319,356,1400000US17163503404,"Census Tract 5034,04,St, Clair County",17|163|503404,Illinois
2771,1184,791,393,1400000US17163503411,"Census Tract 5034,11,St, Clair County",17|163|503411,Illinois
2772,2290,1925,365,1400000US17163503412,"Census Tract 5034,12,St, Clair County",17|163|503412,Illinois
2773,2644,1148,1496,1400000US17163503413,"Census Tract 5034,13,St, Clair County",17|163|503413,Illinois
2774,2093,1023,1070,1400000US17163503414,"Census Tract 5034,14,St, Clair County",17|163|503414,Illinois
2775,1092,930,162,1400000US17163503415,"Census Tract 5034,15,St, Clair County",17|163|503415,Illinois
2776,1701,1105,596,1400000US17163503416,"Census Tract 5034,16,St, Clair County",17|163|503416,Illinois
2777,359,0,359,1400000US17163503800,"Census Tract 5038,St, Clair County",17|163|503800,Illinois
2778,1410,1374,36,1400000US17163503903,"Census Tract 5039,03,St, Clair County",17|163|503903,Illinois
2779,1067,873,194,1400000US17163503905,"Census Tract 5039,05,St, Clair County",17|163|503905,Illinois
2780,1978,1548,430,1400000US17163503906,"Census Tract 5039,06,St, Clair County",17|163|503906,Illinois
2781,2132,1526,606,1400000US17163503907,"Census Tract 5039,07,St, Clair County",17|163|503907,Illinois
2782,1786,580,1206,1400000US17163503908,"Census Tract 5039,08,St, Clair County",17|163|503908,Illinois
2783,2021,1847,174,1400000US17163504001,"Census Tract 5040,01,St, Clair County",17|163|504001,Illinois
2784,2063,1660,403,1400000US17163504002,"Census Tract 5040,02,St, Clair County",17|163|504002,Illinois
2785,1283,1115,168,1400000US17163504351,"Census Tract 5043,51,St, Clair County",17|163|504351,Illinois
2786,1854,1147,707,1400000US17163504352,"Census Tract 5043,52,St, Clair County",17|163|504352,Illinois
2787,1473,1401,72,1400000US17163504353,"Census Tract 5043,53,St, Clair County",17|163|504353,Illinois
2788,2654,1531,1123,1400000US17163504354,"Census Tract 5043,54,St, Clair County",17|163|504354,Illinois
2789,1723,1430,293,1400000US17163504355,"Census Tract 5043,55,St, Clair County",17|163|504355,Illinois
2790,1513,1216,297,1400000US17163504356,"Census Tract 5043,56,St, Clair County",17|163|504356,Illinois
2791,1470,981,489,1400000US17163504357,"Census Tract 5043,57,St, Clair County",17|163|504357,Illinois
2792,1498,1145,353,1400000US17163504358,"Census Tract 5043,58,St, Clair County",17|163|504358,Illinois
2793,1486,1112,374,1400000US17163504359,"Census Tract 5043,59,St, Clair County",17|163|504359,Illinois
2794,1139,207,932,1400000US17163504501,"Census Tract 5045,01,St, Clair County",17|163|504501,Illinois
2795,444,115,329,1400000US17163504502,"Census Tract 5045,02,St, Clair County",17|163|504502,Illinois
2796,618,221,397,1400000US17163504600,"Census Tract 5046,St, Clair County",17|163|504600,Illinois
2797,1015,685,330,1400000US17165955100,"Census Tract 9551,Saline County",17|165|955100,Illinois
2798,983,680,303,1400000US17165955500,"Census Tract 9555,Saline County",17|165|955500,Illinois
2799,1019,894,125,1400000US17165955600,"Census Tract 9556,Saline County",17|165|955600,Illinois
2800,988,814,174,1400000US17165955700,"Census Tract 9557,Saline County",17|165|955700,Illinois
2801,1333,985,348,1400000US17165955800,"Census Tract 9558,Saline County",17|165|955800,Illinois
2802,1038,487,551,1400000US17165955900,"Census Tract 9559,Saline County",17|165|955900,Illinois
2803,1242,905,337,1400000US17165956000,"Census Tract 9560,Saline County",17|165|956000,Illinois
2804,1022,849,173,1400000US17165956100,"Census Tract 9561,Saline County",17|165|956100,Illinois
2805,1386,1184,202,1400000US17165956200,"Census Tract 9562,Saline County",17|165|956200,Illinois
2806,1778,1354,424,1400000US17167000100,"Census Tract 1,Sangamon County",17|167|000100,Illinois
2807,1191,903,288,1400000US17167000201,"Census Tract 2,01,Sangamon County",17|167|000201,Illinois
2808,1483,777,706,1400000US17167000202,"Census Tract 2,02,Sangamon County",17|167|000202,Illinois
2809,1110,686,424,1400000US17167000300,"Census Tract 3,Sangamon County",17|167|000300,Illinois
2810,1002,693,309,1400000US17167000400,"Census Tract 4,Sangamon County",17|167|000400,Illinois
2811,986,931,55,1400000US17167000501,"Census Tract 5,01,Sangamon County",17|167|000501,Illinois
2812,1545,1084,461,1400000US17167000503,"Census Tract 5,03,Sangamon County",17|167|000503,Illinois
2813,1243,1048,195,1400000US17167000504,"Census Tract 5,04,Sangamon County",17|167|000504,Illinois
2814,2103,1328,775,1400000US17167000600,"Census Tract 6,Sangamon County",17|167|000600,Illinois
2815,839,508,331,1400000US17167000700,"Census Tract 7,Sangamon County",17|167|000700,Illinois
2816,733,165,568,1400000US17167000800,"Census Tract 8,Sangamon County",17|167|000800,Illinois
2817,1270,480,790,1400000US17167000900,"Census Tract 9,Sangamon County",17|167|000900,Illinois
2818,941,621,320,1400000US17167001001,"Census Tract 10,01,Sangamon County",17|167|001001,Illinois
2819,702,515,187,1400000US17167001003,"Census Tract 10,03,Sangamon County",17|167|001003,Illinois
2820,2711,1109,1602,1400000US17167001004,"Census Tract 10,04,Sangamon County",17|167|001004,Illinois
2821,1113,840,273,1400000US17167001100,"Census Tract 11,Sangamon County",17|167|001100,Illinois
2822,1549,961,588,1400000US17167001200,"Census Tract 12,Sangamon County",17|167|001200,Illinois
2823,968,203,765,1400000US17167001300,"Census Tract 13,Sangamon County",17|167|001300,Illinois
2824,487,25,462,1400000US17167001400,"Census Tract 14,Sangamon County",17|167|001400,Illinois
2825,1428,474,954,1400000US17167001600,"Census Tract 16,Sangamon County",17|167|001600,Illinois
2826,973,445,528,1400000US17167001800,"Census Tract 18,Sangamon County",17|167|001800,Illinois
2827,1582,545,1037,1400000US17167001900,"Census Tract 19,Sangamon County",17|167|001900,Illinois
2828,1581,1565,16,1400000US17167002001,"Census Tract 20,01,Sangamon County",17|167|002001,Illinois
2829,1211,842,369,1400000US17167002002,"Census Tract 20,02,Sangamon County",17|167|002002,Illinois
2830,1449,1051,398,1400000US17167002100,"Census Tract 21,Sangamon County",17|167|002100,Illinois
2831,1448,1105,343,1400000US17167002200,"Census Tract 22,Sangamon County",17|167|002200,Illinois
2832,829,424,405,1400000US17167002300,"Census Tract 23,Sangamon County",17|167|002300,Illinois
2833,1353,628,725,1400000US17167002400,"Census Tract 24,Sangamon County",17|167|002400,Illinois
2834,2305,1546,759,1400000US17167002500,"Census Tract 25,Sangamon County",17|167|002500,Illinois
2835,1579,1060,519,1400000US17167002600,"Census Tract 26,Sangamon County",17|167|002600,Illinois
2836,1467,930,537,1400000US17167002700,"Census Tract 27,Sangamon County",17|167|002700,Illinois
2837,1415,904,511,1400000US17167002801,"Census Tract 28,01,Sangamon County",17|167|002801,Illinois
2838,1634,253,1381,1400000US17167002802,"Census Tract 28,02,Sangamon County",17|167|002802,Illinois
2839,2331,1528,803,1400000US17167002900,"Census Tract 29,Sangamon County",17|167|002900,Illinois
2840,2035,1229,806,1400000US17167003000,"Census Tract 30,Sangamon County",17|167|003000,Illinois
2841,3305,3045,260,1400000US17167003100,"Census Tract 31,Sangamon County",17|167|003100,Illinois
2842,1824,1581,243,1400000US17167003201,"Census Tract 32,01,Sangamon County",17|167|003201,Illinois
2843,1901,1343,558,1400000US17167003202,"Census Tract 32,02,Sangamon County",17|167|003202,Illinois
2844,2400,2017,383,1400000US17167003203,"Census Tract 32,03,Sangamon County",17|167|003203,Illinois
2845,2050,1619,431,1400000US17167003300,"Census Tract 33,Sangamon County",17|167|003300,Illinois
2846,2238,1914,324,1400000US17167003400,"Census Tract 34,Sangamon County",17|167|003400,Illinois
2847,1903,1574,329,1400000US17167003500,"Census Tract 35,Sangamon County",17|167|003500,Illinois
2848,1069,1014,55,1400000US17167003601,"Census Tract 36,01,Sangamon County",17|167|003601,Illinois
2849,1868,1439,429,1400000US17167003602,"Census Tract 36,02,Sangamon County",17|167|003602,Illinois
2850,2243,2063,180,1400000US17167003603,"Census Tract 36,03,Sangamon County",17|167|003603,Illinois
2851,2310,1641,669,1400000US17167003604,"Census Tract 36,04,Sangamon County",17|167|003604,Illinois
2852,1452,1337,115,1400000US17167003701,"Census Tract 37,01,Sangamon County",17|167|003701,Illinois
2853,1679,1490,189,1400000US17167003702,"Census Tract 37,02,Sangamon County",17|167|003702,Illinois
2854,1092,934,158,1400000US17167003801,"Census Tract 38,01,Sangamon County",17|167|003801,Illinois
2855,2751,2098,653,1400000US17167003802,"Census Tract 38,02,Sangamon County",17|167|003802,Illinois
2856,1992,1897,95,1400000US17167003901,"Census Tract 39,01,Sangamon County",17|167|003901,Illinois
2857,1659,1558,101,1400000US17167003902,"Census Tract 39,02,Sangamon County",17|167|003902,Illinois
2858,1802,1481,321,1400000US17167004000,"Census Tract 40,Sangamon County",17|167|004000,Illinois
2859,718,268,450,1400000US17167004200,"Census Tract 42,Sangamon County",17|167|004200,Illinois
2860,722,647,75,1400000US17169970100,"Census Tract 9701,Schuyler County",17|169|970100,Illinois
2861,1212,853,359,1400000US17169970200,"Census Tract 9702,Schuyler County",17|169|970200,Illinois
2862,758,635,123,1400000US17169970300,"Census Tract 9703,Schuyler County",17|169|970300,Illinois
2863,677,553,124,1400000US17171970600,"Census Tract 9706,Scott County",17|171|970600,Illinois
2864,1266,1052,214,1400000US17171970700,"Census Tract 9707,Scott County",17|171|970700,Illinois
2865,1353,1058,295,1400000US17173959100,"Census Tract 9591,Shelby County",17|173|959100,Illinois
2866,1173,976,197,1400000US17173959200,"Census Tract 9592,Shelby County",17|173|959200,Illinois
2867,2202,1442,760,1400000US17173959300,"Census Tract 9593,Shelby County",17|173|959300,Illinois
2868,1356,1155,201,1400000US17173959400,"Census Tract 9594,Shelby County",17|173|959400,Illinois
2869,1430,1297,133,1400000US17173959500,"Census Tract 9595,Shelby County",17|173|959500,Illinois
2870,1254,1073,181,1400000US17173959600,"Census Tract 9596,Shelby County",17|173|959600,Illinois
2871,1243,900,343,1400000US17175951400,"Census Tract 9514,Stark County",17|175|951400,Illinois
2872,1019,861,158,1400000US17175951500,"Census Tract 9515,Stark County",17|175|951500,Illinois
2873,1691,1466,225,1400000US17177000100,"Census Tract 1,Stephenson County",17|177|000100,Illinois
2874,1263,1081,182,1400000US17177000200,"Census Tract 2,Stephenson County",17|177|000200,Illinois
2875,1590,1328,262,1400000US17177000300,"Census Tract 3,Stephenson County",17|177|000300,Illinois
2876,1049,867,182,1400000US17177000400,"Census Tract 4,Stephenson County",17|177|000400,Illinois
2877,1320,1150,170,1400000US17177000500,"Census Tract 5,Stephenson County",17|177|000500,Illinois
2878,1346,1204,142,1400000US17177000600,"Census Tract 6,Stephenson County",17|177|000600,Illinois
2879,889,601,288,1400000US17177000700,"Census Tract 7,Stephenson County",17|177|000700,Illinois
2880,1333,427,906,1400000US17177000800,"Census Tract 8,Stephenson County",17|177|000800,Illinois
2881,2183,1576,607,1400000US17177000900,"Census Tract 9,Stephenson County",17|177|000900,Illinois
2882,1881,1187,694,1400000US17177001000,"Census Tract 10,Stephenson County",17|177|001000,Illinois
2883,1508,900,608,1400000US17177001100,"Census Tract 11,Stephenson County",17|177|001100,Illinois
2884,1574,747,827,1400000US17177001200,"Census Tract 12,Stephenson County",17|177|001200,Illinois
2885,1626,1090,536,1400000US17177001300,"Census Tract 13,Stephenson County",17|177|001300,Illinois
2886,1231,836,395,1400000US17179020100,"Census Tract 201,Tazewell County",17|179|020100,Illinois
2887,1625,1275,350,1400000US17179020301,"Census Tract 203,01,Tazewell County",17|179|020301,Illinois
2888,1783,1275,508,1400000US17179020302,"Census Tract 203,02,Tazewell County",17|179|020302,Illinois
2889,2210,1689,521,1400000US17179020400,"Census Tract 204,Tazewell County",17|179|020400,Illinois
2890,1873,1691,182,1400000US17179020500,"Census Tract 205,Tazewell County",17|179|020500,Illinois
2891,941,745,196,1400000US17179020600,"Census Tract 206,Tazewell County",17|179|020600,Illinois
2892,2002,1585,417,1400000US17179020700,"Census Tract 207,Tazewell County",17|179|020700,Illinois
2893,1267,708,559,1400000US17179020800,"Census Tract 208,Tazewell County",17|179|020800,Illinois
2894,731,476,255,1400000US17179020900,"Census Tract 209,Tazewell County",17|179|020900,Illinois
2895,2512,1905,607,1400000US17179021000,"Census Tract 210,Tazewell County",17|179|021000,Illinois
2896,2992,1547,1445,1400000US17179021101,"Census Tract 211,01,Tazewell County",17|179|021101,Illinois
2897,2319,1692,627,1400000US17179021102,"Census Tract 211,02,Tazewell County",17|179|021102,Illinois
2898,1999,1504,495,1400000US17179021201,"Census Tract 212,01,Tazewell County",17|179|021201,Illinois
2899,1423,1074,349,1400000US17179021202,"Census Tract 212,02,Tazewell County",17|179|021202,Illinois
2900,2223,1718,505,1400000US17179021203,"Census Tract 212,03,Tazewell County",17|179|021203,Illinois
2901,2782,2485,297,1400000US17179021500,"Census Tract 215,Tazewell County",17|179|021500,Illinois
2902,2206,1942,264,1400000US17179021603,"Census Tract 216,03,Tazewell County",17|179|021603,Illinois
2903,974,397,577,1400000US17179021604,"Census Tract 216,04,Tazewell County",17|179|021604,Illinois
2904,1193,909,284,1400000US17179021605,"Census Tract 216,05,Tazewell County",17|179|021605,Illinois
2905,2328,1962,366,1400000US17179021606,"Census Tract 216,06,Tazewell County",17|179|021606,Illinois
2906,2351,1966,385,1400000US17179021701,"Census Tract 217,01,Tazewell County",17|179|021701,Illinois
2907,2150,1687,463,1400000US17179021702,"Census Tract 217,02,Tazewell County",17|179|021702,Illinois
2908,1530,1061,469,1400000US17179021801,"Census Tract 218,01,Tazewell County",17|179|021801,Illinois
2909,714,671,43,1400000US17179021802,"Census Tract 218,02,Tazewell County",17|179|021802,Illinois
2910,1705,1419,286,1400000US17179021900,"Census Tract 219,Tazewell County",17|179|021900,Illinois
2911,1637,1335,302,1400000US17179022000,"Census Tract 220,Tazewell County",17|179|022000,Illinois
2912,1435,1144,291,1400000US17179022100,"Census Tract 221,Tazewell County",17|179|022100,Illinois
2913,1668,1269,399,1400000US17179022200,"Census Tract 222,Tazewell County",17|179|022200,Illinois
2914,2013,1656,357,1400000US17179022300,"Census Tract 223,Tazewell County",17|179|022300,Illinois
2915,1902,1445,457,1400000US17179022400,"Census Tract 224,Tazewell County",17|179|022400,Illinois
2916,1784,1479,305,1400000US17181950100,"Census Tract 9501,Union County",17|181|950100,Illinois
2917,837,697,140,1400000US17181950200,"Census Tract 9502,Union County",17|181|950200,Illinois
2918,787,619,168,1400000US17181950300,"Census Tract 9503,Union County",17|181|950300,Illinois
2919,2043,1384,659,1400000US17181950400,"Census Tract 9504,Union County",17|181|950400,Illinois
2920,1251,1085,166,1400000US17181950500,"Census Tract 9505,Union County",17|181|950500,Illinois
2921,661,195,466,1400000US17183000100,"Census Tract 1,Vermilion County",17|183|000100,Illinois
2922,588,368,220,1400000US17183000200,"Census Tract 2,Vermilion County",17|183|000200,Illinois
2923,750,458,292,1400000US17183000300,"Census Tract 3,Vermilion County",17|183|000300,Illinois
2924,1017,420,597,1400000US17183000400,"Census Tract 4,Vermilion County",17|183|000400,Illinois
2925,1570,795,775,1400000US17183000500,"Census Tract 5,Vermilion County",17|183|000500,Illinois
2926,789,444,345,1400000US17183000600,"Census Tract 6,Vermilion County",17|183|000600,Illinois
2927,1580,1175,405,1400000US17183000700,"Census Tract 7,Vermilion County",17|183|000700,Illinois
2928,813,554,259,1400000US17183000800,"Census Tract 8,Vermilion County",17|183|000800,Illinois
2929,835,646,189,1400000US17183000900,"Census Tract 9,Vermilion County",17|183|000900,Illinois
2930,1556,932,624,1400000US17183001200,"Census Tract 12,Vermilion County",17|183|001200,Illinois
2931,1745,1355,390,1400000US17183001300,"Census Tract 13,Vermilion County",17|183|001300,Illinois
2932,1148,936,212,1400000US17183010100,"Census Tract 101,Vermilion County",17|183|010100,Illinois
2933,2079,1451,628,1400000US17183010200,"Census Tract 102,Vermilion County",17|183|010200,Illinois
2934,1689,1427,262,1400000US17183010300,"Census Tract 103,Vermilion County",17|183|010300,Illinois
2935,830,724,106,1400000US17183010400,"Census Tract 104,Vermilion County",17|183|010400,Illinois
2936,1386,1093,293,1400000US17183010500,"Census Tract 105,Vermilion County",17|183|010500,Illinois
2937,1672,1318,354,1400000US17183010600,"Census Tract 106,Vermilion County",17|183|010600,Illinois
2938,1277,975,302,1400000US17183010701,"Census Tract 107,01,Vermilion County",17|183|010701,Illinois
2939,1223,946,277,1400000US17183010702,"Census Tract 107,02,Vermilion County",17|183|010702,Illinois
2940,1284,1072,212,1400000US17183010800,"Census Tract 108,Vermilion County",17|183|010800,Illinois
2941,1091,1000,91,1400000US17183010900,"Census Tract 109,Vermilion County",17|183|010900,Illinois
2942,1738,1270,468,1400000US17183011000,"Census Tract 110,Vermilion County",17|183|011000,Illinois
2943,996,760,236,1400000US17183011100,"Census Tract 111,Vermilion County",17|183|011100,Illinois
2944,1430,744,686,1400000US17183011200,"Census Tract 112,Vermilion County",17|183|011200,Illinois
2945,1462,1339,123,1400000US17185957200,"Census Tract 9572,Wabash County",17|185|957200,Illinois
2946,1423,1105,318,1400000US17185957300,"Census Tract 9573,Wabash County",17|185|957300,Illinois
2947,807,570,237,1400000US17185957400,"Census Tract 9574,Wabash County",17|185|957400,Illinois
2948,1039,741,298,1400000US17185957500,"Census Tract 9575,Wabash County",17|185|957500,Illinois
2949,991,835,156,1400000US17187870100,"Census Tract 8701,Warren County",17|187|870100,Illinois
2950,1008,765,243,1400000US17187870200,"Census Tract 8702,Warren County",17|187|870200,Illinois
2951,1152,978,174,1400000US17187870300,"Census Tract 8703,Warren County",17|187|870300,Illinois
2952,1880,1426,454,1400000US17187870400,"Census Tract 8704,Warren County",17|187|870400,Illinois
2953,1787,1238,549,1400000US17187870500,"Census Tract 8705,Warren County",17|187|870500,Illinois
2954,1290,1052,238,1400000US17189950100,"Census Tract 9501,Washington County",17|189|950100,Illinois
2955,1504,1237,267,1400000US17189950200,"Census Tract 9502,Washington County",17|189|950200,Illinois
2956,1308,947,361,1400000US17189950300,"Census Tract 9503,Washington County",17|189|950300,Illinois
2957,1709,1542,167,1400000US17189950400,"Census Tract 9504,Washington County",17|189|950400,Illinois
2958,1373,1175,198,1400000US17191954900,"Census Tract 9549,Wayne County",17|191|954900,Illinois
2959,1618,1362,256,1400000US17191955000,"Census Tract 9550,Wayne County",17|191|955000,Illinois
2960,1361,939,422,1400000US17191955100,"Census Tract 9551,Wayne County",17|191|955100,Illinois
2961,1319,873,446,1400000US17191955200,"Census Tract 9552,Wayne County",17|191|955200,Illinois
2962,1125,931,194,1400000US17191955300,"Census Tract 9553,Wayne County",17|191|955300,Illinois
2963,854,461,393,1400000US17193958000,"Census Tract 9580,White County",17|193|958000,Illinois
2964,1537,1197,340,1400000US17193958100,"Census Tract 9581,White County",17|193|958100,Illinois
2965,1185,884,301,1400000US17193958200,"Census Tract 9582,White County",17|193|958200,Illinois
2966,1068,953,115,1400000US17193958300,"Census Tract 9583,White County",17|193|958300,Illinois
2967,1046,876,170,1400000US17193958400,"Census Tract 9584,White County",17|193|958400,Illinois
2968,1375,1250,125,1400000US17195000100,"Census Tract 1,Whiteside County",17|195|000100,Illinois
2969,1264,1099,165,1400000US17195000200,"Census Tract 2,Whiteside County",17|195|000200,Illinois
2970,1197,958,239,1400000US17195000300,"Census Tract 3,Whiteside County",17|195|000300,Illinois
2971,1282,1034,248,1400000US17195000400,"Census Tract 4,Whiteside County",17|195|000400,Illinois
2972,1626,1164,462,1400000US17195000500,"Census Tract 5,Whiteside County",17|195|000500,Illinois
2973,1700,1306,394,1400000US17195000600,"Census Tract 6,Whiteside County",17|195|000600,Illinois
2974,1019,829,190,1400000US17195000700,"Census Tract 7,Whiteside County",17|195|000700,Illinois
2975,821,672,149,1400000US17195000800,"Census Tract 8,Whiteside County",17|195|000800,Illinois
2976,1481,1048,433,1400000US17195000900,"Census Tract 9,Whiteside County",17|195|000900,Illinois
2977,1026,684,342,1400000US17195001000,"Census Tract 10,Whiteside County",17|195|001000,Illinois
2978,1194,751,443,1400000US17195001101,"Census Tract 11,01,Whiteside County",17|195|001101,Illinois
2979,822,586,236,1400000US17195001102,"Census Tract 11,02,Whiteside County",17|195|001102,Illinois
2980,1685,1129,556,1400000US17195001200,"Census Tract 12,Whiteside County",17|195|001200,Illinois
2981,1182,637,545,1400000US17195001300,"Census Tract 13,Whiteside County",17|195|001300,Illinois
2982,873,713,160,1400000US17195001400,"Census Tract 14,Whiteside County",17|195|001400,Illinois
2983,1500,1083,417,1400000US17195001500,"Census Tract 15,Whiteside County",17|195|001500,Illinois
2984,1026,648,378,1400000US17195001600,"Census Tract 16,Whiteside County",17|195|001600,Illinois
2985,1301,875,426,1400000US17195001700,"Census Tract 17,Whiteside County",17|195|001700,Illinois
2986,820,766,54,1400000US17195001800,"Census Tract 18,Whiteside County",17|195|001800,Illinois
2987,2095,1774,321,1400000US17197880105,"Census Tract 8801,05,Will County",17|197|880105,Illinois
2988,1547,1254,293,1400000US17197880106,"Census Tract 8801,06,Will County",17|197|880106,Illinois
2989,1502,1038,464,1400000US17197880107,"Census Tract 8801,07,Will County",17|197|880107,Illinois
2990,1828,1603,225,1400000US17197880109,"Census Tract 8801,09,Will County",17|197|880109,Illinois
2991,1146,807,339,1400000US17197880111,"Census Tract 8801,11,Will County",17|197|880111,Illinois
2992,593,542,51,1400000US17197880112,"Census Tract 8801,12,Will County",17|197|880112,Illinois
2993,1128,758,370,1400000US17197880113,"Census Tract 8801,13,Will County",17|197|880113,Illinois
2994,920,226,694,1400000US17197880114,"Census Tract 8801,14,Will County",17|197|880114,Illinois
2995,1304,1082,222,1400000US17197880115,"Census Tract 8801,15,Will County",17|197|880115,Illinois
2996,986,893,93,1400000US17197880116,"Census Tract 8801,16,Will County",17|197|880116,Illinois
2997,1568,634,934,1400000US17197880117,"Census Tract 8801,17,Will County",17|197|880117,Illinois
2998,1649,1585,64,1400000US17197880118,"Census Tract 8801,18,Will County",17|197|880118,Illinois
2999,1474,1395,79,1400000US17197880119,"Census Tract 8801,19,Will County",17|197|880119,Illinois
3000,2070,1837,233,1400000US17197880122,"Census Tract 8801,22,Will County",17|197|880122,Illinois
3001,1292,961,331,1400000US17197880123,"Census Tract 8801,23,Will County",17|197|880123,Illinois
3002,954,954,0,1400000US17197880124,"Census Tract 8801,24,Will County",17|197|880124,Illinois
3003,1423,1238,185,1400000US17197880125,"Census Tract 8801,25,Will County",17|197|880125,Illinois
3004,1580,1479,101,1400000US17197880202,"Census Tract 8802,02,Will County",17|197|880202,Illinois
3005,1122,985,137,1400000US17197880203,"Census Tract 8802,03,Will County",17|197|880203,Illinois
3006,2286,1817,469,1400000US17197880204,"Census Tract 8802,04,Will County",17|197|880204,Illinois
3007,1471,1389,82,1400000US17197880303,"Census Tract 8803,03,Will County",17|197|880303,Illinois
3008,1544,1491,53,1400000US17197880304,"Census Tract 8803,04,Will County",17|197|880304,Illinois
3009,1686,1628,58,1400000US17197880305,"Census Tract 8803,05,Will County",17|197|880305,Illinois
3010,2262,1405,857,1400000US17197880307,"Census Tract 8803,07,Will County",17|197|880307,Illinois
3011,1473,1461,12,1400000US17197880309,"Census Tract 8803,09,Will County",17|197|880309,Illinois
3012,1977,1927,50,1400000US17197880314,"Census Tract 8803,14,Will County",17|197|880314,Illinois
3013,1167,1125,42,1400000US17197880315,"Census Tract 8803,15,Will County",17|197|880315,Illinois
3014,1172,953,219,1400000US17197880316,"Census Tract 8803,16,Will County",17|197|880316,Illinois
3015,1892,1775,117,1400000US17197880317,"Census Tract 8803,17,Will County",17|197|880317,Illinois
3016,1119,953,166,1400000US17197880318,"Census Tract 8803,18,Will County",17|197|880318,Illinois
3017,1430,1322,108,1400000US17197880319,"Census Tract 8803,19,Will County",17|197|880319,Illinois
3018,1007,1007,0,1400000US17197880320,"Census Tract 8803,20,Will County",17|197|880320,Illinois
3019,1491,1342,149,1400000US17197880321,"Census Tract 8803,21,Will County",17|197|880321,Illinois
3020,1803,1676,127,1400000US17197880322,"Census Tract 8803,22,Will County",17|197|880322,Illinois
3021,2517,2213,304,1400000US17197880323,"Census Tract 8803,23,Will County",17|197|880323,Illinois
3022,1584,1358,226,1400000US17197880324,"Census Tract 8803,24,Will County",17|197|880324,Illinois
3023,1174,1018,156,1400000US17197880325,"Census Tract 8803,25,Will County",17|197|880325,Illinois
3024,974,826,148,1400000US17197880326,"Census Tract 8803,26,Will County",17|197|880326,Illinois
3025,1702,1462,240,1400000US17197880408,"Census Tract 8804,08,Will County",17|197|880408,Illinois
3026,1181,1039,142,1400000US17197880411,"Census Tract 8804,11,Will County",17|197|880411,Illinois
3027,1443,1274,169,1400000US17197880412,"Census Tract 8804,12,Will County",17|197|880412,Illinois
3028,1576,1481,95,1400000US17197880414,"Census Tract 8804,14,Will County",17|197|880414,Illinois
3029,913,802,111,1400000US17197880416,"Census Tract 8804,16,Will County",17|197|880416,Illinois
3030,974,841,133,1400000US17197880417,"Census Tract 8804,17,Will County",17|197|880417,Illinois
3031,1529,1419,110,1400000US17197880418,"Census Tract 8804,18,Will County",17|197|880418,Illinois
3032,1896,1803,93,1400000US17197880421,"Census Tract 8804,21,Will County",17|197|880421,Illinois
3033,1407,1217,190,1400000US17197880422,"Census Tract 8804,22,Will County",17|197|880422,Illinois
3034,1098,690,408,1400000US17197880423,"Census Tract 8804,23,Will County",17|197|880423,Illinois
3035,1254,1254,0,1400000US17197880424,"Census Tract 8804,24,Will County",17|197|880424,Illinois
3036,1109,999,110,1400000US17197880425,"Census Tract 8804,25,Will County",17|197|880425,Illinois
3037,1213,1183,30,1400000US17197880426,"Census Tract 8804,26,Will County",17|197|880426,Illinois
3038,1072,923,149,1400000US17197880427,"Census Tract 8804,27,Will County",17|197|880427,Illinois
3039,1421,1219,202,1400000US17197880428,"Census Tract 8804,28,Will County",17|197|880428,Illinois
3040,1431,1302,129,1400000US17197880429,"Census Tract 8804,29,Will County",17|197|880429,Illinois
3041,1052,1037,15,1400000US17197880430,"Census Tract 8804,30,Will County",17|197|880430,Illinois
3042,1798,1640,158,1400000US17197880431,"Census Tract 8804,31,Will County",17|197|880431,Illinois
3043,1119,1119,0,1400000US17197880432,"Census Tract 8804,32,Will County",17|197|880432,Illinois
3044,1820,1544,276,1400000US17197880502,"Census Tract 8805,02,Will County",17|197|880502,Illinois
3045,2135,1953,182,1400000US17197880503,"Census Tract 8805,03,Will County",17|197|880503,Illinois
3046,990,873,117,1400000US17197880508,"Census Tract 8805,08,Will County",17|197|880508,Illinois
3047,1286,1106,180,1400000US17197880509,"Census Tract 8805,09,Will County",17|197|880509,Illinois
3048,1038,613,425,1400000US17197880510,"Census Tract 8805,10,Will County",17|197|880510,Illinois
3049,1024,1024,0,1400000US17197880511,"Census Tract 8805,11,Will County",17|197|880511,Illinois
3050,1131,965,166,1400000US17197880601,"Census Tract 8806,01,Will County",17|197|880601,Illinois
3051,1460,947,513,1400000US17197880602,"Census Tract 8806,02,Will County",17|197|880602,Illinois
3052,1707,1258,449,1400000US17197880701,"Census Tract 8807,01,Will County",17|197|880701,Illinois
3053,866,555,311,1400000US17197880702,"Census Tract 8807,02,Will County",17|197|880702,Illinois
3054,2639,2519,120,1400000US17197880901,"Census Tract 8809,01,Will County",17|197|880901,Illinois
3055,1521,489,1032,1400000US17197880903,"Census Tract 8809,03,Will County",17|197|880903,Illinois
3056,1177,918,259,1400000US17197880905,"Census Tract 8809,05,Will County",17|197|880905,Illinois
3057,1759,1606,153,1400000US17197881001,"Census Tract 8810,01,Will County",17|197|881001,Illinois
3058,1684,1514,170,1400000US17197881002,"Census Tract 8810,02,Will County",17|197|881002,Illinois
3059,1112,1078,34,1400000US17197881005,"Census Tract 8810,05,Will County",17|197|881005,Illinois
3060,850,795,55,1400000US17197881006,"Census Tract 8810,06,Will County",17|197|881006,Illinois
3061,1907,1792,115,1400000US17197881007,"Census Tract 8810,07,Will County",17|197|881007,Illinois
3062,2566,2337,229,1400000US17197881009,"Census Tract 8810,09,Will County",17|197|881009,Illinois
3063,1355,1168,187,1400000US17197881010,"Census Tract 8810,10,Will County",17|197|881010,Illinois
3064,1245,1167,78,1400000US17197881011,"Census Tract 8810,11,Will County",17|197|881011,Illinois
3065,881,865,16,1400000US17197881012,"Census Tract 8810,12,Will County",17|197|881012,Illinois
3066,2398,2361,37,1400000US17197881105,"Census Tract 8811,05,Will County",17|197|881105,Illinois
3067,966,814,152,1400000US17197881107,"Census Tract 8811,07,Will County",17|197|881107,Illinois
3068,2353,2329,24,1400000US17197881108,"Census Tract 8811,08,Will County",17|197|881108,Illinois
3069,1434,1183,251,1400000US17197881109,"Census Tract 8811,09,Will County",17|197|881109,Illinois
3070,1132,1050,82,1400000US17197881111,"Census Tract 8811,11,Will County",17|197|881111,Illinois
3071,1706,1575,131,1400000US17197881112,"Census Tract 8811,12,Will County",17|197|881112,Illinois
3072,1911,1837,74,1400000US17197881113,"Census Tract 8811,13,Will County",17|197|881113,Illinois
3073,1626,1528,98,1400000US17197881115,"Census Tract 8811,15,Will County",17|197|881115,Illinois
3074,1339,1324,15,1400000US17197881116,"Census Tract 8811,16,Will County",17|197|881116,Illinois
3075,888,378,510,1400000US17197881201,"Census Tract 8812,01,Will County",17|197|881201,Illinois
3076,716,310,406,1400000US17197881202,"Census Tract 8812,02,Will County",17|197|881202,Illinois
3077,926,587,339,1400000US17197881301,"Census Tract 8813,01,Will County",17|197|881301,Illinois
3078,305,156,149,1400000US17197881302,"Census Tract 8813,02,Will County",17|197|881302,Illinois
3079,1278,701,577,1400000US17197881401,"Census Tract 8814,01,Will County",17|197|881401,Illinois
3080,1360,1114,246,1400000US17197881402,"Census Tract 8814,02,Will County",17|197|881402,Illinois
3081,1158,971,187,1400000US17197881500,"Census Tract 8815,Will County",17|197|881500,Illinois
3082,902,538,364,1400000US17197881601,"Census Tract 8816,01,Will County",17|197|881601,Illinois
3083,1456,486,970,1400000US17197881603,"Census Tract 8816,03,Will County",17|197|881603,Illinois
3084,1137,596,541,1400000US17197881604,"Census Tract 8816,04,Will County",17|197|881604,Illinois
3085,1297,1145,152,1400000US17197881700,"Census Tract 8817,Will County",17|197|881700,Illinois
3086,1440,559,881,1400000US17197881800,"Census Tract 8818,Will County",17|197|881800,Illinois
3087,1542,242,1300,1400000US17197881900,"Census Tract 8819,Will County",17|197|881900,Illinois
3088,668,142,526,1400000US17197882000,"Census Tract 8820,Will County",17|197|882000,Illinois
3089,810,401,409,1400000US17197882100,"Census Tract 8821,Will County",17|197|882100,Illinois
3090,1300,674,626,1400000US17197882200,"Census Tract 8822,Will County",17|197|882200,Illinois
3091,1346,919,427,1400000US17197882300,"Census Tract 8823,Will County",17|197|882300,Illinois
3092,1163,591,572,1400000US17197882400,"Census Tract 8824,Will County",17|197|882400,Illinois
3093,587,236,351,1400000US17197882500,"Census Tract 8825,Will County",17|197|882500,Illinois
3094,1158,722,436,1400000US17197882601,"Census Tract 8826,01,Will County",17|197|882601,Illinois
3095,865,436,429,1400000US17197882602,"Census Tract 8826,02,Will County",17|197|882602,Illinois
3096,957,696,261,1400000US17197882701,"Census Tract 8827,01,Will County",17|197|882701,Illinois
3097,1180,445,735,1400000US17197882702,"Census Tract 8827,02,Will County",17|197|882702,Illinois
3098,1005,674,331,1400000US17197882801,"Census Tract 8828,01,Will County",17|197|882801,Illinois
3099,1125,374,751,1400000US17197882802,"Census Tract 8828,02,Will County",17|197|882802,Illinois
3100,975,511,464,1400000US17197882900,"Census Tract 8829,Will County",17|197|882900,Illinois
3101,989,603,386,1400000US17197883000,"Census Tract 8830,Will County",17|197|883000,Illinois
3102,1447,901,546,1400000US17197883100,"Census Tract 8831,Will County",17|197|883100,Illinois
3103,1799,1349,450,1400000US17197883206,"Census Tract 8832,06,Will County",17|197|883206,Illinois
3104,1402,1075,327,1400000US17197883208,"Census Tract 8832,08,Will County",17|197|883208,Illinois
3105,1108,917,191,1400000US17197883209,"Census Tract 8832,09,Will County",17|197|883209,Illinois
3106,1443,846,597,1400000US17197883210,"Census Tract 8832,10,Will County",17|197|883210,Illinois
3107,1910,1517,393,1400000US17197883211,"Census Tract 8832,11,Will County",17|197|883211,Illinois
3108,2070,1988,82,1400000US17197883212,"Census Tract 8832,12,Will County",17|197|883212,Illinois
3109,2395,2235,160,1400000US17197883213,"Census Tract 8832,13,Will County",17|197|883213,Illinois
3110,933,867,66,1400000US17197883214,"Census Tract 8832,14,Will County",17|197|883214,Illinois
3111,1120,1079,41,1400000US17197883216,"Census Tract 8832,16,Will County",17|197|883216,Illinois
3112,1118,878,240,1400000US17197883217,"Census Tract 8832,17,Will County",17|197|883217,Illinois
3113,1239,1063,176,1400000US17197883218,"Census Tract 8832,18,Will County",17|197|883218,Illinois
3114,1078,844,234,1400000US17197883219,"Census Tract 8832,19,Will County",17|197|883219,Illinois
3115,1254,1204,50,1400000US17197883303,"Census Tract 8833,03,Will County",17|197|883303,Illinois
3116,680,663,17,1400000US17197883304,"Census Tract 8833,04,Will County",17|197|883304,Illinois
3117,1142,996,146,1400000US17197883305,"Census Tract 8833,05,Will County",17|197|883305,Illinois
3118,1099,991,108,1400000US17197883306,"Census Tract 8833,06,Will County",17|197|883306,Illinois
3119,1589,1453,136,1400000US17197883307,"Census Tract 8833,07,Will County",17|197|883307,Illinois
3120,1710,1036,674,1400000US17197883401,"Census Tract 8834,01,Will County",17|197|883401,Illinois
3121,850,624,226,1400000US17197883402,"Census Tract 8834,02,Will County",17|197|883402,Illinois
3122,2194,2026,168,1400000US17197883504,"Census Tract 8835,04,Will County",17|197|883504,Illinois
3123,2613,2395,218,1400000US17197883505,"Census Tract 8835,05,Will County",17|197|883505,Illinois
3124,1412,1345,67,1400000US17197883507,"Census Tract 8835,07,Will County",17|197|883507,Illinois
3125,1858,1671,187,1400000US17197883509,"Census Tract 8835,09,Will County",17|197|883509,Illinois
3126,2048,1847,201,1400000US17197883510,"Census Tract 8835,10,Will County",17|197|883510,Illinois
3127,1629,1472,157,1400000US17197883511,"Census Tract 8835,11,Will County",17|197|883511,Illinois
3128,1741,1680,61,1400000US17197883513,"Census Tract 8835,13,Will County",17|197|883513,Illinois
3129,2349,2329,20,1400000US17197883514,"Census Tract 8835,14,Will County",17|197|883514,Illinois
3130,1627,1518,109,1400000US17197883515,"Census Tract 8835,15,Will County",17|197|883515,Illinois
3131,2332,2211,121,1400000US17197883516,"Census Tract 8835,16,Will County",17|197|883516,Illinois
3132,1253,1007,246,1400000US17197883517,"Census Tract 8835,17,Will County",17|197|883517,Illinois
3133,2222,1900,322,1400000US17197883519,"Census Tract 8835,19,Will County",17|197|883519,Illinois
3134,1252,1041,211,1400000US17197883521,"Census Tract 8835,21,Will County",17|197|883521,Illinois
3135,1137,1067,70,1400000US17197883522,"Census Tract 8835,22,Will County",17|197|883522,Illinois
3136,2535,2298,237,1400000US17197883602,"Census Tract 8836,02,Will County",17|197|883602,Illinois
3137,867,619,248,1400000US17197883603,"Census Tract 8836,03,Will County",17|197|883603,Illinois
3138,1209,549,660,1400000US17197883605,"Census Tract 8836,05,Will County",17|197|883605,Illinois
3139,1255,1156,99,1400000US17197883606,"Census Tract 8836,06,Will County",17|197|883606,Illinois
3140,1603,979,624,1400000US17197883700,"Census Tract 8837,Will County",17|197|883700,Illinois
3141,1187,237,950,1400000US17197883803,"Census Tract 8838,03,Will County",17|197|883803,Illinois
3142,1024,936,88,1400000US17197883804,"Census Tract 8838,04,Will County",17|197|883804,Illinois
3143,1308,1224,84,1400000US17197883806,"Census Tract 8838,06,Will County",17|197|883806,Illinois
3144,587,468,119,1400000US17197883808,"Census Tract 8838,08,Will County",17|197|883808,Illinois
3145,1555,1312,243,1400000US17197883809,"Census Tract 8838,09,Will County",17|197|883809,Illinois
3146,1391,1217,174,1400000US17197883810,"Census Tract 8838,10,Will County",17|197|883810,Illinois
3147,1198,1027,171,1400000US17197883811,"Census Tract 8838,11,Will County",17|197|883811,Illinois
3148,2302,1861,441,1400000US17197883902,"Census Tract 8839,02,Will County",17|197|883902,Illinois
3149,693,606,87,1400000US17197883903,"Census Tract 8839,03,Will County",17|197|883903,Illinois
3150,1770,1186,584,1400000US17197883904,"Census Tract 8839,04,Will County",17|197|883904,Illinois
3151,1533,1198,335,1400000US17197884003,"Census Tract 8840,03,Will County",17|197|884003,Illinois
3152,1221,981,240,1400000US17197884004,"Census Tract 8840,04,Will County",17|197|884004,Illinois
3153,536,455,81,1400000US17197884005,"Census Tract 8840,05,Will County",17|197|884005,Illinois
3154,765,613,152,1400000US17197884006,"Census Tract 8840,06,Will County",17|197|884006,Illinois
3155,1596,1193,403,1400000US17197884101,"Census Tract 8841,01,Will County",17|197|884101,Illinois
3156,885,753,132,1400000US17197884103,"Census Tract 8841,03,Will County",17|197|884103,Illinois
3157,0,0,0,1400000US17197980000,"Census Tract 9800,Will County",17|197|980000,Illinois
3158,21,21,0,1400000US17197980100,"Census Tract 9801,Will County",17|197|980100,Illinois
3159,1548,1045,503,1400000US17199020100,"Census Tract 201,Williamson County",17|199|020100,Illinois
3160,2493,1705,788,1400000US17199020201,"Census Tract 202,01,Williamson County",17|199|020201,Illinois
3161,1005,669,336,1400000US17199020202,"Census Tract 202,02,Williamson County",17|199|020202,Illinois
3162,2196,1682,514,1400000US17199020300,"Census Tract 203,Williamson County",17|199|020300,Illinois
3163,1701,985,716,1400000US17199020400,"Census Tract 204,Williamson County",17|199|020400,Illinois
3164,1541,984,557,1400000US17199020500,"Census Tract 205,Williamson County",17|199|020500,Illinois
3165,1324,1117,207,1400000US17199020600,"Census Tract 206,Williamson County",17|199|020600,Illinois
3166,1799,1481,318,1400000US17199020700,"Census Tract 207,Williamson County",17|199|020700,Illinois
3167,1048,911,137,1400000US17199020801,"Census Tract 208,01,Williamson County",17|199|020801,Illinois
3168,1550,1347,203,1400000US17199020802,"Census Tract 208,02,Williamson County",17|199|020802,Illinois
3169,2320,1610,710,1400000US17199020900,"Census Tract 209,Williamson County",17|199|020900,Illinois
3170,1193,520,673,1400000US17199021001,"Census Tract 210,01,Williamson County",17|199|021001,Illinois
3171,687,512,175,1400000US17199021002,"Census Tract 210,02,Williamson County",17|199|021002,Illinois
3172,542,286,256,1400000US17199021003,"Census Tract 210,03,Williamson County",17|199|021003,Illinois
3173,1335,636,699,1400000US17199021100,"Census Tract 211,Williamson County",17|199|021100,Illinois
3174,1898,1311,587,1400000US17199021200,"Census Tract 212,Williamson County",17|199|021200,Illinois
3175,2122,1782,340,1400000US17199021300,"Census Tract 213,Williamson County",17|199|021300,Illinois
3176,1755,1535,220,1400000US17199021400,"Census Tract 214,Williamson County",17|199|021400,Illinois
3177,1736,1259,477,1400000US17201000101,"Census Tract 1,01,Winnebago County",17|201|000101,Illinois
3178,1005,671,334,1400000US17201000103,"Census Tract 1,03,Winnebago County",17|201|000103,Illinois
3179,1060,642,418,1400000US17201000104,"Census Tract 1,04,Winnebago County",17|201|000104,Illinois
3180,1435,1224,211,1400000US17201000105,"Census Tract 1,05,Winnebago County",17|201|000105,Illinois
3181,1392,742,650,1400000US17201000200,"Census Tract 2,Winnebago County",17|201|000200,Illinois
3182,1700,1043,657,1400000US17201000300,"Census Tract 3,Winnebago County",17|201|000300,Illinois
3183,927,718,209,1400000US17201000401,"Census Tract 4,01,Winnebago County",17|201|000401,Illinois
3184,1263,1093,170,1400000US17201000402,"Census Tract 4,02,Winnebago County",17|201|000402,Illinois
3185,1902,1286,616,1400000US17201000403,"Census Tract 4,03,Winnebago County",17|201|000403,Illinois
3186,1952,1346,606,1400000US17201000501,"Census Tract 5,01,Winnebago County",17|201|000501,Illinois
3187,1459,932,527,1400000US17201000502,"Census Tract 5,02,Winnebago County",17|201|000502,Illinois
3188,1758,1578,180,1400000US17201000506,"Census Tract 5,06,Winnebago County",17|201|000506,Illinois
3189,1471,696,775,1400000US17201000507,"Census Tract 5,07,Winnebago County",17|201|000507,Illinois
3190,1432,1170,262,1400000US17201000510,"Census Tract 5,10,Winnebago County",17|201|000510,Illinois
3191,1086,722,364,1400000US17201000511,"Census Tract 5,11,Winnebago County",17|201|000511,Illinois
3192,2533,1364,1169,1400000US17201000512,"Census Tract 5,12,Winnebago County",17|201|000512,Illinois
3193,1716,1174,542,1400000US17201000513,"Census Tract 5,13,Winnebago County",17|201|000513,Illinois
3194,1458,1221,237,1400000US17201000514,"Census Tract 5,14,Winnebago County",17|201|000514,Illinois
3195,1124,631,493,1400000US17201000515,"Census Tract 5,15,Winnebago County",17|201|000515,Illinois
3196,1484,1337,147,1400000US17201000516,"Census Tract 5,16,Winnebago County",17|201|000516,Illinois
3197,1830,1294,536,1400000US17201000600,"Census Tract 6,Winnebago County",17|201|000600,Illinois
3198,1256,811,445,1400000US17201000700,"Census Tract 7,Winnebago County",17|201|000700,Illinois
3199,1168,350,818,1400000US17201000800,"Census Tract 8,Winnebago County",17|201|000800,Illinois
3200,1183,290,893,1400000US17201001000,"Census Tract 10,Winnebago County",17|201|001000,Illinois
3201,784,81,703,1400000US17201001100,"Census Tract 11,Winnebago County",17|201|001100,Illinois
3202,1004,190,814,1400000US17201001200,"Census Tract 12,Winnebago County",17|201|001200,Illinois
3203,1024,463,561,1400000US17201001300,"Census Tract 13,Winnebago County",17|201|001300,Illinois
3204,1775,869,906,1400000US17201001400,"Census Tract 14,Winnebago County",17|201|001400,Illinois
3205,2466,1452,1014,1400000US17201001500,"Census Tract 15,Winnebago County",17|201|001500,Illinois
3206,2116,860,1256,1400000US17201001600,"Census Tract 16,Winnebago County",17|201|001600,Illinois
3207,1191,768,423,1400000US17201001700,"Census Tract 17,Winnebago County",17|201|001700,Illinois
3208,2119,1036,1083,1400000US17201001800,"Census Tract 18,Winnebago County",17|201|001800,Illinois
3209,1300,962,338,1400000US17201001900,"Census Tract 19,Winnebago County",17|201|001900,Illinois
3210,765,412,353,1400000US17201002000,"Census Tract 20,Winnebago County",17|201|002000,Illinois
3211,730,374,356,1400000US17201002100,"Census Tract 21,Winnebago County",17|201|002100,Illinois
3212,1520,1077,443,1400000US17201002200,"Census Tract 22,Winnebago County",17|201|002200,Illinois
3213,797,598,199,1400000US17201002301,"Census Tract 23,01,Winnebago County",17|201|002301,Illinois
3214,578,403,175,1400000US17201002302,"Census Tract 23,02,Winnebago County",17|201|002302,Illinois
3215,841,358,483,1400000US17201002400,"Census Tract 24,Winnebago County",17|201|002400,Illinois
3216,818,344,474,1400000US17201002500,"Census Tract 25,Winnebago County",17|201|002500,Illinois
3217,829,193,636,1400000US17201002600,"Census Tract 26,Winnebago County",17|201|002600,Illinois
3218,1096,500,596,1400000US17201002700,"Census Tract 27,Winnebago County",17|201|002700,Illinois
3219,458,216,242,1400000US17201002800,"Census Tract 28,Winnebago County",17|201|002800,Illinois
3220,824,49,775,1400000US17201002900,"Census Tract 29,Winnebago County",17|201|002900,Illinois
3221,804,519,285,1400000US17201003000,"Census Tract 30,Winnebago County",17|201|003000,Illinois
3222,1502,428,1074,1400000US17201003100,"Census Tract 31,Winnebago County",17|201|003100,Illinois
3223,1067,489,578,1400000US17201003200,"Census Tract 32,Winnebago County",17|201|003200,Illinois
3224,1311,607,704,1400000US17201003300,"Census Tract 33,Winnebago County",17|201|003300,Illinois
3225,1785,1016,769,1400000US17201003400,"Census Tract 34,Winnebago County",17|201|003400,Illinois
3226,1056,748,308,1400000US17201003500,"Census Tract 35,Winnebago County",17|201|003500,Illinois
3227,758,655,103,1400000US17201003601,"Census Tract 36,01,Winnebago County",17|201|003601,Illinois
3228,1839,767,1072,1400000US17201003602,"Census Tract 36,02,Winnebago County",17|201|003602,Illinois
3229,1183,704,479,1400000US17201003604,"Census Tract 36,04,Winnebago County",17|201|003604,Illinois
3230,1002,231,771,1400000US17201003605,"Census Tract 36,05,Winnebago County",17|201|003605,Illinois
3231,1234,844,390,1400000US17201003606,"Census Tract 36,06,Winnebago County",17|201|003606,Illinois
3232,2000,1862,138,1400000US17201003705,"Census Tract 37,05,Winnebago County",17|201|003705,Illinois
3233,2250,2045,205,1400000US17201003706,"Census Tract 37,06,Winnebago County",17|201|003706,Illinois
3234,1809,516,1293,1400000US17201003707,"Census Tract 37,07,Winnebago County",17|201|003707,Illinois
3235,1392,766,626,1400000US17201003708,"Census Tract 37,08,Winnebago County",17|201|003708,Illinois
3236,661,317,344,1400000US17201003709,"Census Tract 37,09,Winnebago County",17|201|003709,Illinois
3237,964,729,235,1400000US17201003710,"Census Tract 37,10,Winnebago County",17|201|003710,Illinois
3238,1503,1241,262,1400000US17201003711,"Census Tract 37,11,Winnebago County",17|201|003711,Illinois
3239,2318,1734,584,1400000US17201003801,"Census Tract 38,01,Winnebago County",17|201|003801,Illinois
3240,2736,2396,340,1400000US17201003805,"Census Tract 38,05,Winnebago County",17|201|003805,Illinois
3241,1703,1476,227,1400000US17201003806,"Census Tract 38,06,Winnebago County",17|201|003806,Illinois
3242,1551,1224,327,1400000US17201003808,"Census Tract 38,08,Winnebago County",17|201|003808,Illinois
3243,2154,1326,828,1400000US17201003809,"Census Tract 38,09,Winnebago County",17|201|003809,Illinois
3244,2678,1948,730,1400000US17201003810,"Census Tract 38,10,Winnebago County",17|201|003810,Illinois
3245,559,470,89,1400000US17201003811,"Census Tract 38,11,Winnebago County",17|201|003811,Illinois
3246,1805,1673,132,1400000US17201003901,"Census Tract 39,01,Winnebago County",17|201|003901,Illinois
3247,2168,2126,42,1400000US17201003903,"Census Tract 39,03,Winnebago County",17|201|003903,Illinois
3248,1838,1412,426,1400000US17201003904,"Census Tract 39,04,Winnebago County",17|201|003904,Illinois
3249,2394,1806,588,1400000US17201004002,"Census Tract 40,02,Winnebago County",17|201|004002,Illinois
3250,885,687,198,1400000US17201004003,"Census Tract 40,03,Winnebago County",17|201|004003,Illinois
3251,2485,1653,832,1400000US17201004004,"Census Tract 40,04,Winnebago County",17|201|004004,Illinois
3252,1083,1036,47,1400000US17201004005,"Census Tract 40,05,Winnebago County",17|201|004005,Illinois
3253,2037,1719,318,1400000US17201004100,"Census Tract 41,Winnebago County",17|201|004100,Illinois
3254,2395,2106,289,1400000US17201004200,"Census Tract 42,Winnebago County",17|201|004200,Illinois
3255,1962,1780,182,1400000US17201004300,"Census Tract 43,Winnebago County",17|201|004300,Illinois
3256,4,4,0,1400000US17201980000,"Census Tract 9800,Winnebago County",17|201|980000,Illinois
3257,1011,874,137,1400000US17203030100,"Census Tract 301,Woodford County",17|203|030100,Illinois
3258,1154,884,270,1400000US17203030200,"Census Tract 302,Woodford County",17|203|030200,Illinois
3259,972,760,212,1400000US17203030300,"Census Tract 303,Woodford County",17|203|030300,Illinois
3260,2329,2038,291,1400000US17203030400,"Census Tract 304,Woodford County",17|203|030400,Illinois
3261,2805,2524,281,1400000US17203030501,"Census Tract 305,01,Woodford County",17|203|030501,Illinois
3262,963,789,174,1400000US17203030502,"Census Tract 305,02,Woodford County",17|203|030502,Illinois
3263,2551,1657,894,1400000US17203030601,"Census Tract 306,01,Woodford County",17|203|030601,Illinois
3264,1308,1204,104,1400000US17203030602,"Census Tract 306,02,Woodford County",17|203|030602,Illinois
3265,1582,1192,390,1400000US17203030700,"Census Tract 307,Woodford County",17|203|030700,Illinois
